Stadt,"Post-leitzahl 1)","Fläche in km2 2)",insgesamt,männlich,weiblich,"je km2"
"Berlin, Stadt",10178,891.12,3574830,1755700,1819130,4012
"Hamburg, Freie und Hansestadt",20038,755.3,1810438,886289,924149,2397
"München, Landeshauptstadt",80331,310.71,1464301,714112,750189,4713
"Köln, Stadt",50667,405.02,1075935,524790,551145,2657
"Frankfurt am Main, Stadt",60311,248.31,736414,363754,372660,2966
"Stuttgart, Landeshauptstadt",70173,207.33,628032,313295,314737,3029
"Düsseldorf, Stadt",40213,217.41,613230,296231,316999,2821
"Dortmund, Stadt",44135,280.71,585813,287897,297916,2087
"Essen, Stadt",45127,210.34,583084,283065,300019,2772
"Leipzig, Stadt",04109,297.8,571088,280292,290796,1918
"Bremen, Stadt",28195,326.18,565719,279170,286549,1734
"Dresden, Stadt",01067,328.48,547172,272398,274774,1666
"Hannover, Landeshauptstadt",30159,204.3,532864,259559,273305,2608
Nürnberg,90403,186.45,511628,248451,263177,2744
"Duisburg, Stadt",47051,232.8,499845,247099,252746,2147
"Bochum, Stadt",44787,145.66,364920,177592,187328,2505
"Wuppertal, Stadt",42275,168.39,352390,172255,180135,2093
"Bielefeld, Stadt",33602,258.82,333451,161109,172342,1288
"Bonn, Stadt",53111,141.06,322125,153493,168632,2284
"Münster, Stadt",48143,303.28,311846,149412,162434,1028
"Karlsruhe, Stadt",76133,173.42,309999,158207,151792,1788
"Mannheim, Universitätsstadt",68159,144.97,304781,152203,152578,2102
Augsburg,86150,146.87,289584,142033,147551,1972
"Wiesbaden, Landeshauptstadt",65183,203.93,277619,132595,145024,1361
"Gelsenkirchen, Stadt",45879,104.94,262528,130776,131752,2502
"Mönchengladbach, Stadt",41061,170.47,260925,128169,132756,1531
"Braunschweig, Stadt",38100,192.7,248667,122814,125853,1290
"Kiel, Landeshauptstadt",24103,118.65,247441,120473,126968,2085
"Chemnitz, Stadt",09111,221.05,246353,121279,125074,1114
"Aachen, Stadt",52062,160.85,244951,127246,117705,1523
"Magdeburg, Landeshauptstadt",39104,201.01,238136,117527,120609,1185
"Halle (Saale), Stadt",06108,135.02,238005,115198,122807,1763
"Freiburg im Breisgau, Stadt",79098,153.04,227590,108503,119087,1487
"Krefeld, Stadt",47803,137.77,226812,110593,116219,1646
"Lübeck, Hansestadt",23539,214.21,216712,103921,112791,1012
"Mainz, Stadt",55116,97.73,213528,103861,109667,2185
"Oberhausen, Stadt",46045,77.09,211382,103720,107662,2742
"Erfurt, Stadt",99084,269.91,211113,102577,108536,782
"Rostock, Hansestadt",18055,181.36,207513,102082,105431,1144
"Kassel, documenta-Stadt",34117,106.78,199062,97228,101834,1864
"Hagen, Stadt der FernUniversität",58095,160.45,188266,91677,96589,1173
"Saarbrücken, Landeshauptstadt",66111,167.52,179709,89041,90668,1073
"Hamm, Stadt",59065,226.43,179571,88209,91362,793
"Potsdam, Stadt",14461,188.26,171810,83060,88750,913
"Mülheim an der Ruhr, Stadt",45468,91.28,170936,82431,88505,1873
"Ludwigshafen am Rhein, Stadt",67059,77.43,166621,82629,83992,2152
"Oldenburg (Oldenburg), Stadt",26122,103.09,165711,79125,86586,1607
"Osnabrück, Stadt",49074,119.8,164070,79430,84640,1370
"Leverkusen, Stadt",51373,78.87,163113,79343,83770,2068
"Heidelberg, Stadt",69117,108.89,159914,77167,82747,1469
"Solingen, Klingenstadt",42651,89.54,158908,77127,81781,1775
"Darmstadt, Wissenschaftsstadt",64283,122.09,157437,80183,77254,1290
"Herne, Stadt",44623,51.42,156774,76745,80029,3049
"Neuss, Stadt",41460,99.52,152882,74085,78797,1536
"Paderborn, Stadt",33098,179.59,148677,73899,74778,828
Regensburg,93047,80.85,148638,71800,76838,1838
Ingolstadt,85049,133.35,133639,67383,66256,1002
Würzburg,97070,87.6,126010,59978,66032,1438
Fürth,90762,63.35,125403,61372,64031,1980
"Offenbach am Main, Stadt",63065,44.89,124589,61529,63060,2775
"Ulm, Universitätsstadt",89073,118.68,123953,61244,62709,1044
"Wolfsburg, Stadt",38440,204.61,123909,61644,62265,606
"Heilbronn, Stadt",74072,99.89,123771,62188,61583,1239
"Pforzheim, Stadt",75175,98.07,123493,60582,62911,1259
"Göttingen, Stadt",37083,116.93,119177,57943,61234,1019
"Bottrop, Stadt",46236,100.61,117409,57195,60214,1167
"Reutlingen, Stadt",72764,87.04,115006,56748,58258,1321
"Recklinghausen, Stadt",45657,66.5,114003,55494,58509,1714
"Koblenz, Stadt",56068,105.25,113605,55055,58550,1079
"Bremerhaven, Stadt",27576,93.66,113034,56304,56730,1207
"Bergisch Gladbach, Stadt",51465,83.09,111341,53499,57842,1340
"Remscheid, Stadt",42853,74.52,110611,54533,56078,1484
"Jena, Stadt",07743,114.76,110321,54968,55353,961
Erlangen,91052,76.96,110238,54603,55635,1432
"Trier, Stadt",54290,117.07,110111,54231,55880,941
"Moers, Stadt",47441,67.68,103881,50413,53468,1535
"Salzgitter, Stadt",38226,224.49,103668,51528,52140,462
"Siegen, Universitätsstadt",57072,114.69,101863,49735,52128,888
"Hildesheim, Stadt",31134,92.29,101687,48241,53446,1102
"Cottbus, Stadt",03046,165.62,100416,49542,50874,606
"Kaiserslautern, Stadt",67657,139.7,99302,50008,49294,711
"Gütersloh, Stadt",33330,112.02,98466,48898,49568,879
"Witten, Stadt",58452,72.4,96781,47105,49676,1337
"Schwerin, Landeshauptstadt",19053,130.52,95668,46111,49557,733
"Hanau, Brüder-Grimm-Stadt",63450,76.49,95370,47187,48183,1247
"Gera, Stadt",07545,152.19,94750,45757,48993,623
"Iserlohn, Stadt",58636,125.49,93197,45618,47579,743
"Ludwigsburg, Stadt",71638,43.34,93035,45728,47307,2147
"Esslingen am Neckar, Stadt",73728,46.43,92186,45838,46348,1986
"Zwickau, Stadt",08056,102.58,90515,44112,46403,882
"Düren, Stadt",52349,85,90066,44430,45636,1060
"Tübingen, Universitätsstadt",72070,108.07,88347,41944,46403,818
"Flensburg, Stadt",24937,56.74,87432,43617,43815,1541
"Ratingen, Stadt",40878,88.74,87158,41726,45432,982
"Gießen, Universitätsstadt",35390,72.55,86543,42316,44227,1193
"Lünen, Stadt",44532,59.39,86274,42045,44229,1453
"Villingen-Schwenningen, Stadt",78050,165.5,84070,41274,42796,508
"Konstanz, Universitätsstadt",78462,54.11,83789,40262,43527,1548
"Marl, Stadt",45768,87.76,83737,41190,42547,954
"Worms, Stadt",67547,108.73,82595,40542,42053,760
"Dessau-Roßlau, Stadt",06844,244.75,82505,40105,42400,337
"Velbert, Stadt",42551,74.9,81822,39905,41917,1092
"Minden, Stadt",32423,101.12,81637,40087,41550,807
"Neumünster, Stadt",24534,71.63,79680,39438,40242,1112
"Norderstedt, Stadt",22846,58.1,77996,37819,40177,1342
"Delmenhorst, Stadt",27749,62.45,77045,38169,38876,1234
"Viersen, Stadt",41747,91.1,76384,36918,39466,838
"Wilhelmshaven, Stadt",26382,107.07,76201,37511,38690,712
Bamberg,96047,54.62,75743,36286,39457,1387
"Gladbeck, Stadt",45964,35.97,75532,36763,38769,2100
"Rheine, Stadt",48431,145,75338,37264,38074,520
"Dorsten, Stadt",46284,171.2,75196,36603,38593,439
"Marburg, Universitätsstadt",35037,123.92,74675,35645,39030,603
"Troisdorf, Stadt",53840,62,74616,36507,38109,1203
"Lüneburg, Hansestadt",21335,70.5,74494,35901,38593,1057
"Castrop-Rauxel, Stadt",44575,51.68,74004,36011,37993,1432
"Arnsberg, Stadt",59759,193.72,73990,36405,37585,382
"Detmold, Stadt",32756,129.39,73899,35557,38342,571
"Lüdenscheid, Stadt",58507,87.02,73164,35905,37259,841
Bayreuth,95444,66.89,73065,35438,37627,1092
"Brandenburg an der Havel, Stadt",14770,229.72,71664,35380,36284,312
"Bocholt, Stadt",46395,119.4,71350,34938,36412,598
Landshut,84028,65.83,70025,33927,36098,1064
"Celle, Stadt",29221,176.02,69561,33697,35864,395
Aschaffenburg,63739,62.45,69187,33450,35737,1108
"Lippstadt, Stadt",59555,113.68,67812,33375,34437,596
"Dinslaken, Stadt",46535,47.66,67726,32808,34918,1421
"Aalen, Stadt",73430,146.58,67684,33502,34182,462
"Kempten (Allgäu)",87435,63.28,67529,33437,34092,1067
"Fulda, Stadt",36037,104.04,67466,32968,34498,648
"Herford, Hansestadt",32052,79.16,66514,32405,34109,840
"Kerpen, Kolpingstadt",50171,113.96,65568,32252,33316,575
"Plauen, Stadt",08523,102.11,65049,31647,33402,637
"Neuwied, Stadt",56564,86.5,64689,31598,33091,748
"Weimar, Stadt",99423,84.48,64355,31152,33203,762
"Sindelfingen, Stadt",71063,50.83,64159,31833,32326,1262
"Rüsselsheim am Main, Stadt",65428,58.29,64022,31833,32189,1098
"Dormagen, Stadt",41539,85.5,64016,31802,32214,749
"Neubrandenburg, Stadt",17033,86.11,63794,30942,32852,741
"Grevenbroich, Stadt",41515,102.41,62977,30558,32419,615
Rosenheim,83022,37.22,62672,30760,31912,1684
"Herten, Stadt",45699,37.33,61461,30039,31422,1646
"Garbsen, Stadt",30827,79.49,60853,29685,31168,766
"Wesel, Stadt",46483,122.56,60797,29550,31247,496
"Schwäbisch Gmünd, Stadt",73525,113.78,60349,29478,30871,530
"Bergheim, Stadt",50126,96.34,60288,29634,30654,626
"Friedrichshafen, Stadt",88045,69.93,59611,29586,30025,852
"Hürth, Stadt",50354,51.22,59272,28985,30287,1157
"Stralsund, Hansestadt",18439,54.14,59101,29076,30025,1092
"Offenburg, Stadt",77652,78.37,58736,28811,29925,750
"Langenfeld (Rheinland), Stadt",40764,41.15,58563,28461,30102,1423
"Frankfurt (Oder), Stadt",15230,147.85,58193,28116,30077,394
"Greifswald, Hansestadt",17489,50.81,57985,27932,30053,1141
"Euskirchen, Stadt",53879,139.49,57241,28074,29167,410
"Neu-Ulm, GKSt",89231,80.95,56978,28080,28898,704
"Göppingen, Stadt",73033,59.21,56904,28140,28764,961
"Unna, Stadt4)",59423,88.56,/,/,/,/
"Hameln, Stadt",31785,102.53,56747,27063,29684,553
"Stolberg (Rhld.), Kupferstadt",52222,98.48,56366,27937,28429,572
"Sankt Augustin, Stadt",53757,34.22,56115,27428,28687,1640
"Eschweiler, Stadt",52249,75.75,56008,27331,28677,739
"Görlitz, Stadt",02826,67.52,55904,26915,28989,828
"Hilden, Stadt",40721,25.95,55569,26782,28787,2141
"Meerbusch, Stadt",40667,64.39,55091,26219,28872,856
"Waiblingen, Stadt",71332,42.75,54824,26866,27958,1282
"Hattingen, Stadt",45525,71.66,54744,26581,28163,764
"Baden-Baden, Stadt",76530,140.19,54307,25920,28387,387
"Lingen (Ems), Stadt",49808,176.19,53905,26677,27228,306
"Pulheim, Stadt",50259,72.15,53834,25981,27853,746
"Bad Salzuflen, Stadt",32105,100.05,53746,25803,27943,537
"Bad Homburg v. d. Höhe, Stadt",61348,51.16,53707,25444,28263,1050
"Langenhagen, Stadt",30853,71.97,53514,26236,27278,744
"Menden (Sauerland), Stadt",58706,86.1,53315,26180,27135,619
"Nordhorn, Stadt",48529,149.87,53286,26280,27006,356
"Neustadt an der Weinstraße, Stadt",67433,117.09,53209,25873,27336,454
"Ahlen, Stadt",59227,123.13,52905,25899,27006,430
Schweinfurt,97421,35.7,52724,25637,27087,1477
"Wetzlar, Stadt",35578,75.67,52446,25250,27196,693
"Wolfenbüttel, Stadt",38300,78.74,52446,25858,26588,666
"Frechen, Stadt",50226,45.06,52171,25422,26749,1158
"Goslar, Stadt",38640,163.88,51439,25061,26378,314
"Ibbenbüren, Stadt",49477,108.87,51289,25320,25969,471
Passau,94032,69.56,51074,24380,26694,734
"Kleve, Stadt",47533,97.76,51047,25249,25798,522
"Willich, Stadt",47877,67.8,50932,24904,26028,751
"Speyer, Stadt",67346,42.71,50551,24413,26138,1183
"Emden, Stadt",26721,112.34,50486,25205,25281,449
"Gummersbach, Stadt",51643,95.42,50368,24849,25519,528
"Ravensburg, Stadt",88212,92.05,50095,24683,25412,544
"Bad Kreuznach, Stadt",55545,55.56,50034,23729,26305,901
"Peine, Stadt",31224,119.84,49676,24507,25169,415
"Böblingen, Stadt",71032,39.04,49611,24416,25195,1271
"Erftstadt, Stadt",50374,119.89,49513,24033,25480,413
"Elmshorn, Stadt",25335,21.37,49206,24084,25122,2303
"Lörrach, Stadt",79539,39.37,49153,23676,25477,1249
"Bad Oeynhausen, Stadt",32545,64.83,48846,23855,24991,754
"Heidenheim an der Brenz, Stadt",89522,107.09,48709,24145,24564,455
"Cuxhaven, Stadt",27472,161.92,48551,23048,25503,300
"Bergkamen, Stadt",59192,44.9,48543,23947,24596,1081
"Rheda-Wiedenbrück, Stadt",33378,86.72,48526,24273,24253,560
"Rastatt, Stadt",76437,58.98,48494,23980,24514,822
"Frankenthal (Pfalz), Stadt",67227,43.88,48445,23483,24962,1104
"Freising, GKSt",85354,88.59,47848,24051,23797,540
"Bornheim, Stadt",53332,82.69,47749,23342,24407,577
"Leonberg, Stadt",71229,48.73,47744,23707,24037,980
"Singen (Hohentwiel), Stadt",78224,61.77,47603,23154,24449,771
"Soest, Stadt",59494,85.81,47436,22876,24560,553
"Gronau (Westf.), Stadt",48599,78.82,47287,23547,23740,600
"Hennef (Sieg), Stadt",53773,105.89,47237,23043,24194,446
"Stade, Hansestadt",21682,110.07,47194,23073,24121,429
Straubing,94315,67.59,47142,23683,23459,697
"Dachau, GKSt",85221,34.96,46914,23000,23914,1342
"Neunkirchen, Kreisstadt",66538,75.26,46816,23072,23744,622
"Schwerte, Hansestadt an der Ruhr",58239,56.23,46754,22810,23944,832
"Alsdorf, Stadt",52477,31.68,46712,23160,23552,1475
"Herzogenrath, Stadt",52134,33.38,46612,22692,23920,1396
"Dülmen, Stadt",48249,184.83,46523,22627,23896,252
"Wittenberg, Lutherstadt",06886,240.41,46276,22320,23956,192
"Melle, Stadt",49324,253.95,46228,22900,23328,182
"Landau in der Pfalz, Stadt",76829,82.94,46006,21759,24247,555
"Oberursel (Taunus), Stadt",61440,45.37,45849,22195,23654,1011
"Lahr/Schwarzwald, Stadt",77933,69.84,45784,22740,23044,656
"Bünde, Stadt",32257,59.3,45639,22245,23394,770
"Fellbach, Stadt",70734,27.71,45438,22007,23431,1640
"Filderstadt, Stadt",70794,38.55,45389,22513,22876,1177
Hof,95028,58.02,45183,21631,23552,779
"Gotha, Stadt",99867,69.58,45172,22206,22966,649
"Weinheim, Stadt",69469,58.11,44954,21954,23000,774
"Albstadt, Stadt",72458,134.4,44696,22020,22676,333
"Rodgau, Stadt",63110,65.04,44465,22086,22379,684
"Erkrath, Fundort des Neanderthalers, Stadt",40699,26.88,44413,21369,23044,1652
"Brühl, Stadt",50321,36.12,44294,21130,23164,1226
"Bruchsal, Stadt",76646,93.19,44266,22208,22058,475
"Rottenburg am Neckar, Stadt",72108,142.26,44203,22135,22068,311
"Oranienburg, Stadt",16515,163.66,44079,21618,22461,269
"Neustadt am Rübenberge, Stadt",31535,358.96,43902,21771,22131,122
"Lehrte, Stadt",31275,127.67,43720,21685,22035,342
"Kamen, Stadt",59174,40.95,43672,21423,22249,1066
"Erkelenz, Stadt",41812,117.34,43388,21204,22184,370
Memmingen,87700,70.11,43293,21331,21962,617
"Kaarst, Stadt",41564,37.39,43218,20748,22470,1156
Kaufbeuren,87600,40.02,43134,21192,21942,1078
"Falkensee, Stadt",14612,43.27,43105,21107,21998,996
"Bietigheim-Bissingen, Stadt",74321,31.29,43068,21239,21829,1376
"Wismar, Hansestadt",23952,41.72,42992,21023,21969,1031
"Halberstadt, Stadt",38820,142.98,42980,22117,20863,301
"Pinneberg, Stadt",25421,21.54,42638,20701,21937,1979
"Eisenach, Stadt",99817,104.17,42588,20969,21619,409
"Weiden i.d.OPf.",92637,70.57,42494,20457,22037,602
"Borken, Stadt",46325,152.97,42388,20838,21550,277
Amberg,92224,50.13,42348,20901,21447,845
"Nordhausen, Stadt",99734,105.62,42129,20660,21469,399
"Nettetal, Stadt",41334,83.87,42093,20804,21289,502
"Homburg, Kreisstadt",66424,82.61,42040,20562,21478,509
"Gifhorn, Stadt",38518,105.39,42019,20753,21266,399
"Aurich, Stadt",26603,197.29,41793,20579,21214,212
"Freiberg, Stadt, Universitätsstadt",09599,48.32,41642,20955,20687,862
Ansbach,91522,99.91,41532,19885,21647,416
"Wunstorf, Stadt",31515,125.74,41478,20210,21268,330
"Heinsberg, Stadt",52525,92.21,41471,20386,21085,450
"Laatzen, Stadt",30880,34.16,41389,20031,21358,1212
"Lemgo, Stadt",32657,100.85,41087,20309,20778,407
Coburg,96450,48.29,41071,19929,21142,851
"Dreieich, Stadt",63303,53.3,41042,20125,20917,770
"Siegburg, Stadt",53721,23.66,41034,20149,20885,1734
"Königswinter, Stadt",53639,76.17,40927,19936,20991,537
"Monheim am Rhein, Stadt",40789,23.05,40814,19633,21181,1771
"Nürtingen, Stadt",72622,46.88,40752,20364,20388,869
Schwabach,91126,40.8,40707,19821,20886,998
"Weißenfels, Stadt",06667,113.55,40671,20632,20039,358
"Pirmasens, Stadt",66953,61.36,40416,19684,20732,659
"Bensheim, Stadt",64625,57.83,40168,19662,20506,695
"Stendal, Hansestadt",39576,268.02,40164,19671,20493,150
"Kirchheim unter Teck, Stadt",73230,40.47,40130,19826,20304,991
"Germering, GKSt",82110,21.6,40039,19296,20743,1853
"Buxtehude, Hansestadt",21614,76.69,40033,19907,20126,522
"Eberswalde, Stadt",16225,93.64,40019,19708,20311,427
"Bautzen, Stadt",02625,66.69,39963,19425,20538,599
"Bitterfeld-Wolfen, Stadt",06766,86.96,39843,19252,20591,458
"Löhne, Stadt",32584,59.51,39767,19457,20310,668
"Leinfelden-Echterdingen, Stadt",70771,29.89,39688,19732,19956,1328
"Völklingen, Stadt",66333,67.1,39574,19277,20297,590
"Neumarkt i.d.OPf., GKSt",92318,79.01,39573,19306,20267,501
"Schorndorf, Stadt",73614,56.83,39520,19385,20135,695
"Hofheim am Taunus, Kreisstadt",65719,57.38,39517,19265,20252,689
"Hückelhoven, Stadt",41836,61.27,39423,19502,19921,643
"Freital, Stadt",01705,40.45,39361,19177,20184,973
"Ettlingen, Stadt",76275,56.75,39332,19208,20124,693
"Schwäbisch Hall, Stadt",74523,104.24,39328,19058,20270,377
"Ahaus, Stadt",48683,151.24,39314,19651,19663,260
"Ostfildern, Stadt",73760,22.81,38835,19188,19647,1702
"Würselen, Stadt",52146,34.39,38823,19033,19790,1129
"Maintal, Stadt",63477,32.4,38739,19085,19654,1196
"Mettmann, Stadt",40822,42.56,38734,18661,20073,910
"Buchholz in der Nordheide, Stadt",21244,74.76,38689,18512,20177,518
"Pirna, Stadt",01796,53.06,38187,18556,19631,720
"Haltern am See, Stadt",45721,159.03,37893,18455,19438,238
"Niederkassel, Stadt",53859,35.79,37828,18674,19154,1057
"Bernau bei Berlin, Stadt",16321,104.17,37725,18378,19347,362
"Neu-Isenburg, Stadt",63263,24.31,37563,18508,19055,1545
"Kamp-Lintfort, Stadt",47475,63.14,37414,18402,19012,593
"Langen (Hessen), Stadt",63225,29.12,37252,18343,18909,1279
"Fürstenfeldbruck, GKSt",82256,32.53,37176,18425,18751,1143
"Warendorf, Stadt",48231,176.88,37127,18041,19086,210
"Greven, Stadt",48268,140.26,37097,18318,18779,264
"Beckum, Stadt",59269,111.46,36729,18170,18559,330
"Papenburg, Stadt",26871,118.44,36698,18645,18053,310
"Backnang, Stadt",71522,39.38,36633,18172,18461,930
"Königs Wusterhausen, Stadt",15711,96.04,36468,17909,18559,380
"Coesfeld, Stadt",48653,141.36,36374,17907,18467,257
"Erding, GKSt",85435,54.61,36291,17565,18726,665
"Emsdetten, Stadt",48282,72.06,36288,18025,18263,504
"Voerde (Niederrhein), Stadt",46562,53.49,36273,17748,18525,678
"St. Ingbert, Stadt",66386,49.95,36069,17305,18764,722
"Wesseling, Stadt",50389,23.37,35768,17691,18077,1530
"Porta Westfalica, Stadt",32457,105.22,35698,17648,18050,339
"Suhl, Stadt",98527,103.03,35608,17337,18271,346
"Sinsheim, Stadt",74889,126.99,35410,17681,17729,279
"Kehl, Stadt",77694,75.07,35391,17487,17904,471
"Lage, Stadt",32791,76.04,35099,17317,17782,462
"Tuttlingen, Stadt",78532,90.45,34946,17378,17568,386
"Meppen, Stadt",49716,188.4,34935,17210,17725,185
"Kempen, Stadt",47906,68.8,34865,16997,17868,507
"Saarlouis, Kreisstadt",66740,43.28,34849,16960,17889,805
"Limburg a.d. Lahn, Kreisstadt",65549,45.15,34808,17183,17625,771
"Wermelskirchen, Stadt",42929,74.8,34638,16917,17721,463
"Datteln, Stadt",45711,66.1,34555,16930,17625,523
"Zweibrücken, Stadt",66482,70.64,34428,17012,17416,487
"Winsen (Luhe), Stadt",21423,109.79,34284,16838,17446,312
"Cloppenburg, Stadt",49661,70.86,34216,16825,17391,483
"Mörfelden-Walldorf, Stadt",64546,44.15,34135,17211,16924,773
"Leer (Ostfriesland), Stadt",26789,70.11,34129,17008,17121,487
"Viernheim, Stadt",68519,48.4,34100,16734,17366,705
"Merseburg, Stadt",06217,53.76,33931,16526,17405,631
"Barsinghausen, Stadt",30890,102.81,33922,16739,17183,330
"Dietzenbach, Kreisstadt",63128,21.67,33903,16934,16969,1564
"Radebeul, Stadt",01445,26.14,33826,16333,17493,1294
"Hemer, Stadt4)",58675,67.66,/,/,/,/
"Geldern, Stadt",47608,96.97,33778,16901,16877,348
"Seelze, Stadt",30926,54.08,33763,16704,17059,624
"Balingen, Stadt",72336,90.32,33750,16407,17343,374
"Crailsheim, Stadt",74564,109.08,33735,16962,16773,309
"Goch, Stadt",47574,115.43,33701,16885,16816,292
"Uelzen, Hansestadt",29525,136.84,33633,16338,17295,246
"Steinfurt, Stadt",48565,111.67,33633,16678,16955,301
"Hoyerswerda, Stadt",02977,95.53,33552,16132,17420,351
"Bernburg (Saale), Stadt",06406,113.48,33536,16409,17127,296
"Kornwestheim, Stadt",70806,14.65,33502,16599,16903,2287
"Bad Vilbel, Stadt",61118,25.68,33458,16229,17229,1303
"Wedel, Stadt",22880,33.82,33322,16155,17167,985
"Mühlhausen/Thüringen, Stadt",99974,86.74,33214,16080,17134,383
"Korschenbroich, Stadt",41352,55.26,32947,16040,16907,596
"Ahrensburg, Stadt",22926,35.3,32936,15630,17306,933
"Wernigerode, Stadt",38855,170.18,32911,15624,17287,193
"Rheinfelden (Baden), Stadt",79618,62.82,32804,16069,16735,522
"Altenburg, Stadt",04600,45.69,32788,15888,16900,718
"Naumburg (Saale), Stadt",06618,129.9,32784,15889,16895,252
"Deggendorf, GKSt",94469,77.14,32782,16090,16692,425
"Biberach an der Riß, Stadt",88400,72.15,32704,16108,16596,453
"Lampertheim, Stadt",68623,72.28,32554,16113,16441,450
"Jülich, Stadt",52428,90.39,32454,16197,16257,359
"Vechta, Stadt",49377,87.88,32179,15943,16236,366
"Fürstenwalde/Spree, Stadt",15517,70.68,32025,15884,16141,453
"Delbrück, Stadt",33129,157.28,31949,16295,15654,203
"Forchheim, GKSt",91301,44.45,31942,15366,16576,719
"Bad Nauheim, Stadt",61231,32.54,31924,15040,16884,981
"Itzehoe, Stadt",25524,28.03,31896,15266,16630,1138
"Georgsmarienhütte, Stadt",49124,55.45,31594,15471,16123,570
"Oer-Erkenschwick, Stadt",45739,38.66,31569,15639,15930,817
"Achim, Stadt",28832,68.06,31422,15276,16146,462
"Rheinberg, Stadt",47495,75.24,31356,15353,16003,417
"Nienburg (Weser), Stadt",31582,64.53,31354,15205,16149,486
"Herrenberg, Stadt",71083,65.7,31253,15275,15978,476
"Bramsche, Stadt",49565,183.39,31110,15799,15311,170
"Kreuztal, Stadt",57223,71.07,31082,15409,15673,437
"Einbeck, Stadt",37574,231.92,31076,15156,15920,134
"Schönebeck (Elbe), Stadt",39218,86.02,31063,15010,16053,361
"Geestland, Stadt",27607,356.83,31040,15136,15904,87
"Neuruppin, Stadt",16816,305.25,31037,15208,15829,102
"Gevelsberg, Stadt",58285,26.34,30966,15076,15890,1176
"Riesa, Stadt",01589,58.91,30894,14992,15902,524
"Emmerich am Rhein, Stadt",46446,80.4,30852,15583,15269,384
"Werl, Stadt",59457,76.35,30843,15776,15067,404
"Radolfzell am Bodensee, Stadt",78315,58.55,30784,14897,15887,526
"Geesthacht, Stadt",21502,33.25,30453,14917,15536,916
"Haan, Stadt",42781,24.19,30414,14574,15840,1257
"Osterholz-Scharmbeck, Stadt",27711,147.17,30398,14921,15477,207
"Lohmar, Stadt",53797,65.62,30395,14968,15427,463
"Burgdorf, Stadt",31303,112.56,30320,14872,15448,269
"Schwedt/Oder, Stadt",16303,205.56,30182,14509,15673,147
"Weil am Rhein, Stadt",79576,19.46,30164,14621,15543,1550
"Meschede, Kreis- und  Hochschulstadt",59872,218.5,30081,14893,15188,138
"Ennepetal, Stadt der Kluterthöhle",58256,57.77,29901,14581,15320,518
"Werne, Stadt",59368,76.14,29858,14488,15370,392
"Merzig, Kreisstadt",66663,108.98,29812,14742,15070,274
"Andernach, Stadt",56626,53.34,29679,14389,15290,556
"Bad Hersfeld, Kreisstadt",36251,73.82,29615,14477,15138,401
"Neuburg a.d.Donau, GKSt",86633,81.29,29587,14908,14679,364
"Friedberg, St",86316,81.25,29510,14438,15072,363
"Taunusstein, Stadt",65232,67.03,29470,14278,15192,440
"Rietberg, Stadt",33397,110.31,29444,14861,14583,267
"Höxter, Stadt",37671,158.16,29420,14564,14856,186
"Gaggenau, Stadt",76571,65.01,29315,14406,14909,451
"Oelde, Stadt",59302,102.77,29265,14670,14595,285
"Waltrop, Stadt",45731,47.09,29245,14195,15050,621
"Tönisvorst, Stadt",47918,44.34,29235,14239,14996,659
"Güstrow, Stadt",18273,71.09,29215,14139,15076,411
"Vaihingen an der Enz, Stadt",71665,73.4,29041,14469,14572,396
"Northeim, Stadt",37154,145.85,28966,14163,14803,199
"Bretten, Stadt",75015,71.1,28959,14416,14543,407
"Bühl, Stadt",77815,73.18,28903,14186,14717,395
"Zeitz, Stadt",06712,87.18,28826,13988,14838,331
"Landsberg am Lech, GKSt",86899,57.91,28824,14395,14429,498
"Springe, Stadt",31832,160.12,28807,13976,14831,180
"Rösrath, Stadt",51503,38.8,28778,14126,14652,742
"Unterschleißheim, St",85716,14.93,28761,14509,14252,1927
"Kelkheim (Taunus), Stadt",65779,30.65,28691,14079,14612,936
"Schwandorf, GKSt",92421,123.81,28621,14291,14330,231
"Friedberg (Hessen), Kreisstadt",61169,50.17,28596,14279,14317,570
"Schwelm, Stadt",58332,20.49,28477,13722,14755,1390
"Idar-Oberstein, Stadt",55743,91.58,28373,13880,14493,310
"Grimma, Stadt",04668,218.25,28322,13952,14370,130
"Kevelaer, Stadt",47623,100.64,28287,13916,14371,281
"Rendsburg, Stadt",24768,23.73,28190,13926,14264,1188
"Wegberg, Stadt",41844,84.34,28165,13886,14279,334
"Winnenden, Stadt",71364,28.05,28152,13956,14196,1004
"Mühlheim am Main, Stadt",63165,20.67,28130,13925,14205,1361
"Leichlingen (Rheinland), Blütenstadt",42799,37.26,28101,13546,14555,754
"Sundern (Sauerland), Stadt",59846,193.27,28000,14069,13931,145
"Meißen, Stadt",01662,30.92,27984,13481,14503,905
"Bad Neuenahr-Ahrweiler, Stadt",53474,63.38,27844,13005,14839,439
"Wetter (Ruhr), Stadt",58300,31.55,27785,13680,14105,881
"Königsbrunn, St",86343,18.4,27780,13727,14053,1510
"Aschersleben, Stadt",06449,156.22,27751,13399,14352,178
"Baunatal, Stadt",34225,38.26,27704,13408,14296,724
"Rödermark, Stadt",63322,29.99,27579,13468,14111,920
"Geislingen an der Steige, Stadt",73312,75.83,27550,13744,13806,363
"Verden (Aller), Stadt",27283,71.7,27539,13341,14198,384
"Emmendingen, Stadt",79312,33.78,27511,13301,14210,814
"Reinbek, Stadt",21465,31.23,27366,13460,13906,876
"Olching, St",82140,29.92,27345,13332,14013,914
"Hattersheim am Main, Stadt",65795,15.81,27312,13634,13678,1727
"Sangerhausen, Stadt",06526,207.66,27265,13363,13902,131
"Mechernich, Stadt",53894,136.48,27235,13616,13619,200
"Rheinbach, Stadt",53359,69.72,27217,13530,13687,390
"Neukirchen-Vluyn, Stadt",47506,43.5,27200,13174,14026,625
"Wangen im Allgäu, Stadt",88239,101.35,27135,13207,13928,268
"Overath, Stadt",51491,68.88,27118,13375,13743,394
"Griesheim, Stadt",64347,21.55,27103,13567,13536,1258
"Leimen, Stadt",69181,20.64,27076,13297,13779,1312
"Baesweiler, Stadt",52499,27.76,27029,13197,13832,974
"Geilenkirchen, Stadt",52511,83.2,26991,13415,13576,324
"Hamminkeln, Stadt",46499,164.53,26808,13396,13412,163
"Schloß Holte-Stukenbrock, Stadt",33758,67.52,26770,13170,13600,396
"Weinstadt, Stadt",71384,31.71,26750,13144,13606,844
"Wiesloch, Stadt",69168,30.24,26542,13194,13348,878
"Lohne (Oldenburg), Stadt",49393,91.11,26447,13495,12952,290
"Strausberg, Stadt",15344,67.95,26387,12698,13689,388
"Neckarsulm, Stadt",74172,24.94,26379,13106,13273,1058
"Lauf a.d.Pegnitz, St",91207,59.77,26378,12860,13518,441
"Eisenhüttenstadt, Stadt",15890,63.47,26325,12771,13554,415
"Nordenham, Stadt",26954,87.77,26294,13059,13235,300
"Köthen (Anhalt), Stadt",06366,78.44,26281,12841,13440,335
"Staßfurt, Stadt",39418,146.71,26173,12734,13439,178
"Hennigsdorf, Stadt",16761,31.47,26139,12816,13323,831
"St. Wendel, Kreisstadt",66606,113.53,26106,12808,13298,230
"Heiligenhaus, Stadt",42579,27.52,26010,12742,13268,945
"Ilmenau, Stadt",98693,62.73,25946,13484,12462,414
"Remseck am Neckar, Stadt",71686,22.82,25876,12761,13115,1134
"Butzbach, Friedrich-Ludwig-Weidig-Stadt",35510,106.6,25866,12889,12977,243
"Kulmbach, GKSt",95326,92.77,25853,12498,13355,279
"Mühlacker, Stadt",75417,54.32,25804,12817,12987,475
"Ehingen (Donau), Stadt",89584,178.33,25796,13044,12752,145
"Lennestadt, Stadt",57368,135.59,25755,12957,12798,190
"Heppenheim (Bergstraße), Kreisstadt",64646,52.14,25725,12726,12999,493
"Zittau, Stadt",02763,66.75,25723,12564,13159,385
"Selm, Stadt",59379,60.41,25714,12525,13189,426
"Bad Honnef, Stadt",53604,48.17,25705,12349,13356,534
"Hohen Neuendorf, Stadt",16540,48.56,25696,12470,13226,529
"Teltow, Stadt",14513,21.6,25667,12605,13062,1188
"Brilon, Stadt",59929,229.16,25611,12541,13070,112
"Weiterstadt, Stadt",64331,34.4,25572,12936,12636,743
"Lübbecke, Stadt",32312,65.04,25555,12413,13142,393
"Plettenberg, Stadt",58840,96.76,25528,12728,12800,264
"Rinteln, Stadt",31737,109.02,25527,12517,13010,234
"Zirndorf, St",90513,28.79,25515,12310,13205,886
"Verl, Stadt",33415,71.37,25465,13019,12446,357
"Bingen am Rhein, Stadt",55411,37.71,25435,12518,12917,674
"Pfaffenhofen a.d.Ilm, St",85276,92.64,25409,12663,12746,274
"Werder (Havel), Stadt",14542,117.05,25345,12508,12837,217
"Petershagen, Stadt",32469,211.94,25335,12752,12583,120
"Achern, Stadt",77855,65.24,25319,12563,12756,388
"Friedrichsdorf, Stadt",61381,30.16,25284,12472,12812,838
"Lindau (Bodensee), GKSt",88131,33.06,25249,12111,13138,764
"Ludwigsfelde, Stadt",14974,109.98,25245,12479,12766,230
"Rottweil, Stadt",78628,71.76,25200,12395,12805,351
"Norden, Stadt",26506,106.32,25195,12270,12925,237
"Wiehl, Stadt",51674,53.26,25177,12212,12965,473
"Salzkotten, Stadt",33154,109.8,25106,12421,12685,229
"Roth, St",91154,96.33,25102,12245,12857,261
"Warstein, Stadt",59581,158.03,25041,12525,12516,158
"Sprockhövel, Stadt",45549,47.94,25032,12074,12958,522
"Bad Oldesloe, Stadt",23843,52.6,25005,12180,12825,475
"Ingelheim am Rhein, Stadt",55218,49.86,24998,12337,12661,501
"Schmallenberg, Stadt",57392,303.1,24997,12689,12308,82
"Saalfeld/Saale, Stadt",07318,48.73,24911,11992,12919,511
"Harsewinkel, Die Mähdrescherstadt",33428,100.59,24862,12584,12278,247
"Delitzsch, Stadt",04509,85.92,24815,12140,12675,289
"Weingarten, Stadt",88250,12.16,24808,11890,12918,2040
"Schleswig, Stadt",24837,24.3,24773,12071,12702,1019
"Senftenberg, Stadt",01968,127.56,24773,12063,12710,194
"Espelkamp, Stadt",32339,84.21,24766,12092,12674,294
"Ditzingen, Stadt",71254,30.38,24698,12265,12433,813
"Groß-Gerau, Stadt",64521,54.48,24695,12283,12412,453
"Horb am Neckar, Stadt",72160,119.76,24687,12481,12206,206
"Pfungstadt, Stadt",64319,42.53,24645,12140,12505,579
"Ellwangen (Jagst), Stadt",73479,127.38,24643,12466,12177,193
"Obertshausen, Stadt",63179,13.62,24573,11976,12597,1804
"Idstein, Hochschulstadt",65510,79.69,24558,11842,12716,308
"Lüdinghausen, Stadt",59348,140.54,24556,12215,12341,175
"Meckenheim, Stadt",53340,34.84,24553,11989,12564,705
"Olpe, Stadt",57462,85.88,24511,11931,12580,285
"Geretsried, St",82538,24.6,24483,12056,12427,995
"Markkleeberg, Stadt",04416,31.44,24477,11693,12784,779
"Quedlinburg, Welterbestadt",06484,120.44,24411,11618,12793,203
"Arnstadt, Stadt",99310,55.08,24340,11859,12481,442
"Syke, Stadt",28857,128.11,24298,12018,12280,190
"Attendorn, Hansestadt",57439,97.95,24279,12161,12118,248
"Rathenow, Stadt",14712,113.1,24243,11772,12471,214
"Salzwedel, Hansestadt",29410,304.58,24199,12028,12171,79
"Stutensee, Stadt",76297,45.68,24199,11980,12219,530
"Übach-Palenberg, Stadt",52531,26.12,24198,12167,12031,926
"Limbach-Oberfrohna, Stadt",09212,50.21,24113,11701,12412,480
"Ronnenberg, Stadt",30952,37.89,24050,11936,12114,635
"Eisleben, Lutherstadt",06295,143.87,23940,11692,12248,166
"Varel, Stadt",26316,113.75,23936,11646,12290,210
"Waldshut-Tiengen, Stadt",79761,77.97,23873,11738,12135,306
"Döbeln, Stadt",04720,91.74,23823,11698,12125,260
"Sonneberg, Stadt",96515,84.69,23804,11551,12253,281
"Hann. Münden, Stadt",34346,121.16,23797,11721,12076,196
"Öhringen, Stadt",74613,67.79,23771,11862,11909,351
"Haren (Ems), Stadt",49733,208.79,23747,11988,11759,114
"Sehnde, Stadt",31319,103.58,23584,11891,11693,228
"Korbach, Hansestadt, Kreisstadt",34497,123.98,23583,11483,12100,190
"Bedburg, Stadt",50181,80.42,23577,11906,11671,293
"Dillenburg, Stadt",35683,83.89,23542,11614,11928,281
"Warburg, Hansestadt",34414,168.84,23365,11591,11774,138
"Netphen, Stadt",57250,137.39,23356,11682,11674,170
"Riedstadt, Stadt",64560,73.73,23340,11618,11722,317
"Helmstedt, Stadt",38350,47.14,23336,11347,11989,495
"Bad Mergentheim, Stadt",97980,129.96,23227,11265,11962,179
"Starnberg, St",82319,61.85,23207,10904,12303,375
"Calw, Stadt",75365,59.88,23158,11726,11432,387
"Walsrode, Stadt",29664,272.29,23139,11433,11706,85
"Mosbach, Stadt",74821,62.17,23101,11457,11644,372
"Husum, Stadt",25813,25.81,23097,11075,12022,895
"Herzogenaurach, St",91074,47.62,23081,11594,11487,485
"Wertheim, Stadt",97877,138.59,23052,11488,11564,166
"Waldkraiburg, St",84478,21.56,23042,11484,11558,1069
"Glauchau, Stadt",08371,51.62,22925,11276,11649,444
"Burg, Stadt",39288,164.05,22834,11552,11282,139
"Gardelegen, Hansestadt",39638,632.43,22826,11411,11415,36
"Gelnhausen, Barbarossast., Krst.",63571,45.19,22796,11224,11572,504
"Freudenstadt, Stadt",72250,87.54,22796,11059,11737,260
"Herdecke, Stadt",58313,22.39,22768,10841,11927,1017
"Spremberg, Stadt",03130,202.32,22750,11065,11685,112
"Rudolstadt, Stadt",07407,55.41,22704,11019,11685,410
"Vreden, Stadt",48691,135.83,22611,11533,11078,166
"Überlingen, Stadt",88662,58.66,22573,10517,12056,385
"Lengerich, Stadt",49525,90.79,22530,11145,11385,248
"Leutkirch im Allgäu, Stadt",88299,174.98,22515,11298,11217,129
"Radevormwald, Stadt auf der Höhe",42477,53.86,22473,10961,11512,417
"Westerstede, Stadt",26655,179.55,22399,10972,11427,125
"Bad Soden am Taunus, Stadt",65812,12.55,22393,10695,11698,1785
"Donaueschingen, Stadt",78166,104.67,22356,11322,11034,214
"Weilheim i.OB, St",82362,55.5,22345,10746,11599,403
"Apolda, Stadt",99510,46.27,22279,10966,11313,482
"Karben, Stadt",61184,43.94,22211,11079,11132,505
"Stadthagen, Stadt",31655,60.27,22148,10705,11443,367
"Senden, St",89250,25.21,22128,10818,11310,878
"Gersthofen, St",86368,34.01,22120,10984,11136,650
"Friesoythe, Stadt",26169,247.49,22082,11134,10948,89
"Osterode am Harz, Stadt",37520,102.54,21985,10900,11085,214
"Sondershausen, Stadt",99706,201.21,21974,10787,11187,109
"Bad Harzburg, Stadt",38667,65.52,21969,10260,11709,335
"Nagold, Stadt",72202,63.09,21949,10921,11028,348
"Eckernförde, Stadt",24340,21.38,21942,10429,11513,1026
"Büdingen, Stadt",63654,122.88,21902,11010,10892,178
"Bad Kissingen, GKSt",97688,69.92,21879,10078,11801,313
"Zerbst/Anhalt, Stadt",39261,467.77,21876,10753,11123,47
"Neusäß, St",86356,25.22,21861,10493,11368,867
"Waldkirch, Stadt",79183,48.47,21786,10581,11205,449
"Laupheim, Stadt",88471,61.79,21742,10861,10881,352
"Metzingen, Stadt",72555,34.55,21721,10661,11060,629
"Halle (Westf.), Stadt",33790,69.7,21692,10764,10928,311
"Büren, Stadt",33142,170.99,21657,11174,10483,127
"Hockenheim, Stadt",68766,34.84,21625,10845,10780,621
"Schwetzingen, Stadt",68723,21.62,21580,10453,11127,998
"Xanten, Stadt",46509,72.43,21551,10604,10947,298
"Rotenburg (Wümme), Stadt",27356,99.06,21548,10573,10975,218
"Versmold, Stadt",33775,85.57,21543,10868,10675,252
"Heide, Stadt",25746,31.97,21529,10208,11321,673
"Sonthofen, St",87527,46.55,21529,10304,11225,463
"Eppingen, Stadt",75031,88.58,21446,10681,10765,242
"Stadtallendorf, Stadt",35260,78.29,21388,10640,10748,273
"Wipperfürth, Hansestadt",51688,118.3,21372,10561,10811,181
"Waren (Müritz), Stadt",17192,159.46,21367,10061,11306,134
"Soltau, Stadt",29614,203.77,21324,10449,10875,105
"Puchheim, St",82178,12.24,21300,10315,10985,1741
"Wülfrath, Stadt",42489,32.27,21273,10384,10889,659
"Elsdorf, Stadt",50189,66.17,21264,10450,10814,321
"Eschborn, Stadt",65760,12.13,21228,10407,10821,1749
"Meiningen, Stadt",98617,59.46,21223,10452,10771,357
"Seligenstadt, Stadt",63500,30.85,21184,10297,10887,687
"Rees, Stadt",46459,109.86,21140,10404,10736,192
"Aichach, St",86551,92.84,21130,10306,10824,228
"Geseke, Stadt",59590,97.88,21129,10499,10630,216
"Flörsheim am Main, Stadt",65439,22.95,21121,10320,10801,920
"Reichenbach im Vogtland, Stadt",08468,34.46,21112,10174,10938,613
"Groß-Umstadt, Stadt",64823,86.84,21058,10451,10607,242
"Schramberg, Stadt",78713,80.7,21048,10537,10511,261
"Bad Rappenau, Stadt",74906,73.56,20946,10324,10622,285
"Greiz, Stadt",07973,76.44,20920,10130,10790,274
"Fröndenberg/Ruhr, Stadt",58730,56.23,20908,10285,10623,372
"Werdau, Stadt",08412,65.63,20905,10238,10667,319
"Traunreut, St",83301,45.06,20899,10329,10570,464
"Kitzingen, GKSt",97318,46.99,20892,10170,10722,445
"Blieskastel, Stadt",66440,108.21,20886,10362,10524,193
"Kaltenkirchen, Stadt",24568,23.1,20852,10219,10633,903
"Coswig, Stadt",01640,25.88,20841,9994,10847,805
"Waghäusel, Stadt",68753,42.84,20811,10336,10475,486
"Quickborn, Stadt",25451,43.17,20808,10106,10702,482
"Germersheim, Stadt",76726,21.68,20777,10461,10316,958
"Duderstadt, Stadt",37115,95.64,20677,10149,10528,216
"Meinerzhagen, Stadt",58540,115.67,20650,10332,10318,179
"Herborn, Stadt",35745,63.8,20618,10124,10494,323
"Burgwedel, Stadt",30938,152.85,20594,9815,10779,135
"Luckenwalde, Stadt",14943,46.61,20521,9962,10559,440
"Enger, Widukindstadt",32130,41.24,20483,10074,10409,497
"Bruchköbel, Stadt",63486,29.69,20475,10018,10457,690
"Wittmund, Stadt",26409,210.15,20437,10062,10375,97
"Neustrelitz, Stadt",17235,139.86,20426,9893,10533,146
"Schortens, Stadt",26419,68.8,20416,9980,10436,297
"Eislingen/Fils, Stadt",73054,16.41,20390,10025,10365,1243
"Stadtlohn, Stadt",48703,79.25,20389,10263,10126,257
"Dillingen/ Saar, Stadt",66763,22.05,20385,9942,10443,924
"Rheinstetten, Stadt",76287,32.31,20365,9942,10423,630
"Annaberg-Buchholz, Stadt",09456,28.15,20292,9747,10545,721
"Günzburg, GKSt",89312,55.4,20289,9987,10302,366
"Mössingen, Stadt",72116,50.03,20286,9847,10439,406
"Blankenburg (Harz), Stadt",38889,148.94,20189,9740,10449,136
"Holzminden, Stadt",37603,88.24,20189,9965,10224,229
"Bad Schwartau, Stadt",23611,18.39,20096,9364,10732,1093
"Bad Waldsee, Stadt",88339,108.55,20090,9795,10295,185
"Lichtenfels, St",96215,122.16,20064,9874,10190,164
"Torgau, Stadt",04860,102.8,20062,9941,10121,195
"Nidderau, Stadt",61130,46.73,20051,9975,10076,429
"Hörstel, Stadt",48477,107.54,20038,10068,9970,186
"Nördlingen, GKSt",86720,68.09,20005,9887,10118,294
"Zülpich, Stadt",53909,101.01,19998,9820,10178,198
"Schifferstadt, Stadt",67105,28.06,19983,9927,10056,712
"Traunstein, GKSt",83278,48.57,19983,9575,10408,411
"Ennigerloh, Stadt",59320,125.56,19973,10012,9961,159
"Oberkirch, Stadt",77704,69.09,19955,9923,10032,289
"Oschersleben (Bode), Stadt",39387,188.92,19953,9785,10168,106
"Marsberg, Stadt",34431,182.22,19826,10120,9706,109
"Donauwörth, GKSt",86609,77.04,19749,9901,9848,256
"Eschwege, Kreisstadt",37269,63.27,19716,9542,10174,312
"Telgte, Stadt",48291,90.84,19697,9506,10191,217
"Gerlingen, Stadt",70839,17.01,19689,9620,10069,1158
"Mühldorf a.Inn, St",84453,29.42,19660,9750,9910,668
"Schopfheim, Stadt",79650,67.94,19645,9513,10132,289
"Ochtrup, Stadt",48607,105.63,19634,9979,9655,186
"Giengen an der Brenz, Stadt",89537,44.07,19568,9784,9784,444
"Wildeshausen, Stadt",27793,89.7,19560,9680,9880,218
"Sulzbach-Rosenberg, St",92237,53.12,19456,9586,9870,366
"Bückeburg, Stadt",31675,68.9,19381,9340,10041,281
"Borna, Stadt",04552,62.44,19319,9322,9997,309
"Haiger, Stadt",35708,106.67,19316,9554,9762,181
"Seesen, Stadt",38723,102.32,19314,9363,9951,189
"Dingolfing, St",84130,44,19311,10040,9271,439
"Waldbröl, Stadt",51545,63.32,19283,9406,9877,305
"Prenzlau, Stadt",17291,142.96,19279,9285,9994,135
"Bad Berleburg, Stadt",57319,275.52,19261,9675,9586,70
"Sarstedt, Stadt",31157,43,19261,9477,9784,448
"Haldensleben, Stadt",39340,156.2,19246,9584,9662,123
"Rhede, Stadt",46414,78.9,19215,9551,9664,244
"Korntal-Münchingen, Stadt",70825,20.71,19195,9546,9649,927
"Schenefeld, Stadt",22869,9.99,19168,9345,9823,1919
"Bad Pyrmont, Stadt",31812,61.99,19154,9042,10112,309
"Schmalkalden, Kurort, Stadt",98574,98.3,19149,9729,9420,195
"Bad Krozingen, Stadt",79189,35.65,19136,9204,9932,537
"Bad Friedrichshall, Stadt",74177,24.71,19087,9639,9448,773
"Alfeld (Leine), Stadt",31061,72.88,19061,9367,9694,262
"Hechingen, Stadt",72379,66.41,19047,9442,9605,287
"Mayen, Stadt",56727,58.19,19000,9429,9571,327
"Weil der Stadt, Stadt",71263,43.17,18983,9480,9503,440
"Crimmitschau, Stadt",08451,61.15,18982,9157,9825,310
"Mölln, Stadt",23879,25.05,18970,9069,9901,757
"Bergneustadt, Stadt",51702,37.89,18947,9270,9677,500
"Heusenstamm, Stadt",63150,19.03,18932,9361,9571,995
"Tettnang, Stadt",88069,71.25,18889,9407,9482,265
"Müllheim, Stadt",79379,57.91,18887,9147,9740,326
"Sömmerda, Stadt",99610,81.11,18884,9270,9614,233
"Hemmingen, Stadt",30966,31.73,18872,9198,9674,595
"Lebach, Stadt",66822,64.21,18864,9576,9288,294
"Auerbach/Vogtl., Stadt",08209,55.52,18779,9043,9736,338
"Wittlich, Stadt",54516,49.63,18748,9442,9306,378
"Püttlingen, Stadt",66346,23.95,18700,9044,9656,781
"Vlotho, Stadt",32602,76.93,18663,9287,9376,243
"Forst (Lausitz), Stadt",03149,110.7,18651,9076,9575,168
"Schneverdingen, Stadt",29640,234.92,18624,9053,9571,79
"Leinefelde-Worbis, Stadt",37327,96.87,18622,9281,9341,192
"Bremervörde, Stadt",27432,150.42,18608,9380,9228,124
"Bad Dürkheim, Stadt",67098,102.55,18601,8779,9822,181
"Bad Aibling, St",83043,41.4,18595,8958,9637,449
"Dillingen a.d.Donau, GKSt",89407,75.59,18538,9129,9409,245
"Bad Tölz, St",83646,30.8,18527,8845,9682,602
"Wolfratshausen, St",82515,9.13,18491,8960,9531,2025
"Radeberg, Stadt",01454,29.83,18491,9109,9382,620
"Alzenau, St",63755,59.3,18467,9044,9423,311
"Burghausen, St",84489,19.81,18431,8977,9454,930
"Marktoberdorf, St",87616,95.15,18390,9112,9278,193
"Sachsenheim, Stadt",74343,57.92,18386,9123,9263,317
"Kolbermoor, St",83059,19.83,18371,8991,9380,927
"Bad Driburg, Stadt4)",33014,115.3,/,/,/,/
"Glinde, Stadt",21509,11.22,18335,8996,9339,1634
"Burscheid, Stadt",51399,27.33,18288,9050,9238,669
"Kronberg im Taunus, Stadt",61476,18.62,18275,8585,9690,981
"Uetersen, Stadt",25436,11.43,18272,8964,9308,1599
"Großenhain, Stadt",01558,130.36,18268,8996,9272,140
"Weißenburg i.Bay., GKSt",91781,97.58,18256,8955,9301,187
"Pfullingen, Stadt",72793,30.14,18251,8867,9384,605
"Konz, Stadt",54329,44.56,18206,8906,9300,409
"Moosburg a.d.Isar, St",85368,43.85,18181,9124,9057,415
"Hessisch Oldendorf, Stadt",31840,120.32,18170,8964,9206,151
"Zossen, Stadt",15806,180.4,18115,9031,9084,100
"Alzey, Stadt",55232,35.22,18114,8973,9141,514
"Pohlheim, Stadt",35415,38,18094,8860,9234,476
"Schwalmstadt, Stadt",34613,84.74,18087,9176,8911,213
"Lahnstein, Stadt",56112,37.62,18068,8715,9353,480
"Vellmar, Stadt",34246,13.97,18067,8528,9539,1293
"Wassenberg, Stadt",41849,42.43,18019,8892,9127,425
"Parchim, Stadt",19370,124.82,17964,8719,9245,144
"Buchen (Odenwald), Stadt",74722,138.93,17922,8867,9055,129
"Schkeuditz, Stadt",04435,81.47,17900,9220,8680,220
"Werdohl, Stadt",58791,33.39,17892,8869,9023,536
"Bexbach, Stadt",66450,31.09,17782,8715,9067,572
"Frankenberg (Eder), Stadt",35066,124.87,17773,8825,8948,142
"Wörth am Rhein, Stadt",76744,131.62,17762,8731,9031,135
"Bad Reichenhall, GKSt",83435,41.92,17752,8450,9302,423
"Freudenberg, Stadt",57258,54.6,17734,8854,8880,325
"Thale, Stadt",06502,137.58,17708,8750,8958,129
"Oberasbach, St",90522,12.08,17553,8423,9130,1452
"Renningen, Stadt",71272,31.15,17510,8779,8731,562
"Sinzig, Stadt",53489,41.1,17503,8539,8964,426
"Sigmaringen, Stadt",72488,92.84,17494,9000,8494,188
"Guben, Stadt",03172,43.99,17471,8359,9112,397
"Nauen, Stadt",14641,268.14,17436,8651,8785,65
"Bad Segeberg, Stadt",23795,18.87,17427,8365,9062,924
"Bad Saulgau, Stadt",88348,97.33,17426,8497,8929,179
"Bad Langensalza, Stadt",99947,123.67,17397,8516,8881,141
"Bad Münder am Deister, Stadt",31848,107.97,17384,8489,8895,161
"Hochheim am Main, Stadt",65239,19.43,17358,8450,8908,893
"Wittenberge, Stadt",19322,50.63,17318,8374,8944,342
"Nidda, Stadt",63667,118.35,17293,8675,8618,146
"Bad Münstereifel, Stadt",53902,150.83,17291,8441,8850,115
"Marktredwitz, GKSt",95615,49.52,17262,8281,8981,349
"Oerlinghausen, Stadt",33813,32.69,17259,8447,8812,528
"Marienberg, Stadt",09496,133.5,17254,8553,8701,129
"Horn-Bad Meinberg, Stadt",32805,90.15,17253,8387,8866,191
"Altena, Stadt",58762,44.42,17218,8507,8711,388
"Schwarzenberg/Erzgeb., Stadt",08340,46.31,17191,8206,8985,371
"Gescher, Glockenstadt",48712,80.84,17175,8661,8514,212
"Bobingen, St",86399,50.25,17130,8483,8647,341
"Illertissen, St",89257,36.39,17130,8409,8721,471
"Garching b.München, St",85748,28.17,17099,8829,8270,607
"Bad Säckingen, Stadt",79713,25.34,17073,8273,8800,674
"Eutin, Stadt",23701,41.4,17041,8035,9006,412
"Eltville am Rhein, Stadt",65343,46.77,16999,8233,8766,363
"Bad Wildungen, Stadt",34537,120.08,16980,8325,8655,141
"Heilbad Heiligenstadt, Stadt",37308,62.26,16962,8465,8497,272
"Damme, Stadt",49401,104.39,16940,8496,8444,162
"Schrobenhausen, St",86529,75.26,16936,8364,8572,225
"Kronach, St",96317,66.98,16917,8228,8689,253
"Stockach, Stadt",78333,69.73,16813,8328,8485,241
"Bendorf, Stadt",56170,24.12,16809,8225,8584,697
"Babenhausen, Stadt",64832,66.87,16729,8425,8304,250
"Cham, St",93413,80.69,16701,8264,8437,207
"Weißwasser/O.L., Stadt",02943,63.42,16660,7962,8698,263
"Freilassing, St",83395,14.81,16648,8060,8588,1124
"Diepholz, Stadt",49356,104.68,16521,8156,8365,158
"Gunzenhausen, St",91710,82.72,16513,7893,8620,200
"Finsterwalde, Stadt",03238,77.21,16497,7893,8604,214
"Penzberg, St",82377,25.73,16479,8075,8404,640
"Königstein im Taunus, Stadt",61462,25.07,16474,7770,8704,657
"Kelheim, St",93309,76.7,16472,8274,8198,215
"Remagen, Stadt",53424,33.21,16469,8094,8375,496
"Brakel, Stadt",33034,173.92,16449,8293,8156,95
"Sulzbach/ Saar, Stadt",66280,16.07,16419,8040,8379,1022
"Kirchhain, Stadt",35274,90.92,16412,8125,8287,181
"Heidenau, Stadt",01809,11.07,16399,8078,8321,1482
"Trossingen, Stadt",78647,24.2,16394,8222,8172,677
"Ginsheim-Gustavsburg, Stadt",65462,13.94,16347,8003,8344,1173
"Hünfeld, Konrad-Zuse-Stadt",36088,119.77,16327,8221,8106,136
"Wurzen, Stadt",04808,69.04,16293,7802,8491,236
"Wendlingen am Neckar, Stadt",73240,12.15,16282,8084,8198,1340
"Kierspe, Stadt",58566,71.91,16272,8049,8223,226
"Schwarzenbek, Stadt",21493,11.56,16261,8000,8261,1407
"Halver, Stadt",58553,77.23,16259,7967,8292,211
"Reinheim, Stadt",64354,27.7,16254,8004,8250,587
"Vilshofen an der Donau, St",94474,86.29,16250,8072,8178,188
"Aue, Stadt",08280,20.92,16235,7757,8478,776
"Bürstadt, Stadt",68642,34.46,16176,8044,8132,469
"Bargteheide, Stadt",22941,15.82,16135,7738,8397,1020
"Templin, Stadt",17268,379.49,16117,7849,8268,42
"Zeulenroda-Triebes, Stadt",07937,135.14,16115,7812,8303,119
"Lübbenau/Spreewald, Stadt",03222,139.4,16109,7823,8286,116
"Michelstadt, Stadt",64720,86.98,16055,7928,8127,185
"Preetz, Stadt",24211,14.4,16032,7637,8395,1113
"Erwitte, Stadt",59597,89.41,16018,7907,8111,179
"Kelsterbach, Stadt",65451,15.37,16001,8230,7771,1041
"Raunheim, Stadt",65479,12.61,16000,8030,7970,1269
"Alsfeld, Stadt",36304,129.69,15982,7880,8102,123
"Freiberg am Neckar, Stadt",71691,13.14,15959,7838,8121,1215
"Brackenheim, Stadt",74336,45.75,15912,7974,7938,348
"Schlüchtern, Stadt",36381,113.31,15911,7848,8063,140
"Straelen, Stadt",47638,74.04,15901,7943,7958,215
"Königslutter am Elm, Stadt",38154,131.12,15880,7829,8051,121
"Blaustein, Stadt",89134,55.61,15873,7940,7933,285
"Wadern, Stadt",66687,111.14,15808,7832,7976,142
"Bassum, Stadt",27211,168.85,15737,7808,7929,93
"Bad Wörishofen, St",86825,57.79,15731,7445,8286,272
"Bad Salzungen, Stadt",36433,39.04,15696,7692,8004,402
"Bad Lippspringe, Stadt",33175,51.01,15695,7633,8062,308
"Marbach am Neckar, Stadt",71672,18.06,15682,7676,8006,868
"Dieburg, Stadt",64807,23.08,15592,7618,7974,676
"Eilenburg, Stadt",04838,46.84,15578,7520,8058,333
"Weener, Stadt",26826,81.23,15541,7755,7786,191
"Clausthal-Zellerfeld, Berg- und Universitätsstadt",38678,43.69,15523,8681,6842,355
"Bad Arolsen, Stadt",34454,126.38,15501,7633,7868,123
"Markranstädt, Stadt",04420,58.46,15489,7520,7969,265
"Pocking, St",94060,68.86,15482,7526,7956,225
"Drensteinfurt, Stadt",48317,106.6,15471,7679,7792,145
"Walldorf, Stadt",69190,19.91,15460,7739,7721,777
"Schwalbach am Taunus, Stadt",65824,6.47,15452,7432,8020,2388
"Rahden, Stadt",32369,137.48,15451,7779,7672,112
"Füssen, St",87629,43.48,15425,7406,8019,355
"Boppard, Stadt",56154,74.88,15409,7542,7867,206
"Breisach am Rhein, Stadt",79206,54.59,15388,7624,7764,282
"Ebersbach an der Fils, Stadt",73061,26.26,15363,7641,7722,585
"Taucha, Stadt",04425,33.23,15356,7450,7906,462
"Bad Bentheim, Stadt",48455,99.99,15353,7623,7730,154
"Bad Neustadt a.d.Saale, St",97616,36.89,15334,7390,7944,416
"Blomberg, Stadt",32825,99.1,15274,7634,7640,154
"Altdorf b.Nürnberg, St",90518,48.59,15274,7526,7748,314
"Hofgeismar, Stadt",34369,86.39,15247,7373,7874,176
"Künzelsau, Stadt",74653,75.17,15246,7692,7554,203
"Eppelheim, Stadt",69214,5.7,15241,7494,7747,2675
"Hückeswagen, Schloss-Stadt",42499,50.52,15214,7560,7654,301
"Neustadt in Holstein, Stadt",23730,19.74,15211,7190,8021,771
"Ribnitz-Damgarten, Stadt",18311,122.83,15208,7229,7979,124
"Neustadt b.Coburg, GKSt",96465,61.89,15181,7411,7770,245
"Ober-Ramstadt, Stadt",64372,41.88,15174,7464,7710,362
"Kamenz, Stadt",01917,53.25,15153,7448,7705,285
"Brake (Unterweser), Stadt",26919,38.3,15149,7385,7764,395
"Lohr a.Main, St",97816,90.42,15145,7496,7649,167
"Witzenhausen, Stadt",37213,126.69,15092,7350,7742,119
"Hilchenbach, Stadt",57271,81.12,15039,7451,7588,185
"Landsberg, Stadt",06188,125.38,15013,7512,7501,120
"Löbau, Stadt",02708,78.9,15003,7274,7729,190
"Selb, GKSt",95100,86.07,14999,7270,7729,174
"Schriesheim, Stadt",69198,31.61,14983,7271,7712,474
"Munster, Stadt",29633,194.52,14958,7706,7252,77
"Mainburg, St",84048,61.53,14926,7573,7353,243
"Mittweida, Stadt, Hochschulstadt",09648,41.26,14907,7410,7497,361
"Langenau, Stadt",89129,75.03,14892,7476,7416,198
"Karlstadt, St",97753,98.14,14885,7338,7547,152
"Stadtbergen, St",86391,11.49,14848,7186,7662,1292
"Gehrden, Stadt",30989,43.24,14845,7102,7743,343
"Hohenstein-Ernstthal, Stadt",09337,18.58,14820,7097,7723,798
"Lauchhammer, Stadt",01979,88.9,14791,7203,7588,166
"Markgröningen, Stadt",71706,28.15,14752,7448,7304,524
"Mindelheim, St",87719,56.42,14748,7339,7409,261
"Olsberg, Stadt",59939,118,14747,7326,7421,125
"Fritzlar, Dom- und Kaiserstadt",34560,88.78,14715,7255,7460,166
"Kraichtal, Stadt",76703,80.59,14701,7315,7386,182
"Neu-Anspach, Stadt",61267,36.14,14698,7252,7446,407
"Spenge, Stadt",32139,40.35,14681,7173,7508,364
"Eberbach, Stadt",69412,81.15,14670,7065,7605,181
"Meerane, Stadt",08393,19.81,14659,7028,7631,740
"Oschatz, Stadt",04758,55.44,14609,7145,7464,264
"Lauda-Königshofen, Stadt",97922,94.44,14588,7260,7328,154
"Ottweiler, Stadt",66564,45.56,14571,7252,7319,320
"Bad Wurzach, Stadt",88410,182.24,14564,7433,7131,80
"Bitburg, Stadt",54634,47.55,14540,6995,7545,306
"Sandersdorf-Brehna, Stadt",06792,81.84,14530,7093,7437,178
"Ratzeburg, Stadt",23909,30.29,14528,6862,7666,480
"Dorfen, St",84405,99.56,14494,7269,7225,146
"Dippoldiswalde, Stadt",01744,103.99,14478,7173,7305,139
"Pattensen, Stadt",30982,67.13,14447,7041,7406,215
"Hettstedt, Stadt",06333,36.93,14444,7086,7358,391
"Genthin, Stadt",39307,230.73,14402,7152,7250,62
"Sassenberg, Stadt",48336,78.08,14371,7238,7133,184
"Rotenburg a. d. Fulda, Stadt",36199,79.83,14349,7157,7192,180
"Uslar, Stadt",37170,113.58,14345,7059,7286,126
"Uhingen, Stadt",73066,24.79,14312,7083,7229,577
"Münsingen, Stadt",72525,116.93,14311,7063,7248,122
"Wittstock/Dosse, Stadt",16909,420.24,14291,7043,7248,34
"Frankenberg/Sa., Stadt",09669,65.62,14288,7092,7196,218
"Jessen (Elster), Stadt",06917,352.12,14247,7094,7153,40
"Usingen, Stadt",61250,55.83,14229,7007,7222,255
"Immenstadt i.Allgäu, St",87509,81.43,14207,6921,7286,174
"Gernsbach, Stadt",76593,82.03,14202,6984,7218,173
"Jever, Stadt",26441,42.23,14201,6767,7434,336
"Erlensee, Stadt",63526,18.59,14196,7034,7162,764
"Schneeberg, Stadt",08289,23.35,14193,6907,7286,608
"Wanzleben-Börde, Stadt",39164,188.07,14175,7107,7068,75
"Bad Camberg, Stadt",65520,54.63,14148,6979,7169,259
"Bad Bramstedt, Stadt",24576,24.14,14139,6965,7174,586
"Lauterbach (Hessen), Kreisstadt",36341,102,14110,6988,7122,138
"Plochingen, Stadt",73207,10.64,14086,6950,7136,1324
"Wilsdruff, Stadt",01723,81.6,14004,6929,7075,172
"Bebra, Stadt",36179,93.64,13963,6892,7071,149
"Murrhardt, Stadt",71540,71.15,13953,6905,7048,196
"Homberg (Efze), Reformationsstadt, Kreisstadt",34576,99.99,13950,6951,6999,140
"Leuna, Stadt",06237,87.71,13911,6937,6974,159
"Oberndorf am Neckar, Stadt",78727,55.92,13907,6936,6971,249
"Langenselbold, Stadt",63505,26.26,13900,6787,7113,529
"Oebisfelde-Weferlingen, Stadt",39646,249.31,13889,6998,6891,56
"Kalkar, Stadt",47546,88.2,13880,6882,6998,157
"Lübben (Spreewald), Stadt",15907,120.85,13861,6669,7192,115
"Isny im Allgäu, Stadt",88316,85.39,13846,6872,6974,162
"Schwabmünchen, St",86830,55.5,13837,6810,7027,249
"Stein, St",90547,19.51,13828,6573,7255,709
"Markdorf, Stadt",88677,40.91,13811,6794,7017,338
"Bad Laasphe, Stadt",57334,135.95,13802,6940,6862,102
"Angermünde, Stadt",16278,324.2,13797,6623,7174,43
"Neustadt a.d.Donau, St",93333,93.53,13797,7055,6742,148
"Zeven, Stadt",27404,74.14,13797,6982,6815,186
"Grünberg, Stadt",35305,89.24,13717,6775,6942,154
"Biedenkopf, Stadt",35216,90.33,13713,6827,6886,152
"Eppstein, Stadt",65817,24.21,13702,6747,6955,566
"Aßlar, Stadt",35614,43.57,13655,6753,6902,313
"Melsungen, Stadt",34212,63.1,13647,6730,6917,216
"Abensberg, St",93326,60.27,13646,7052,6594,226
"Bergen auf Rügen, Stadt",18528,51.49,13618,6534,7084,264
"Schwentinental, Stadt",24223,17.82,13608,6594,7014,764
"Neutraubling, St",93073,9.75,13593,6686,6907,1394
"Südliches Anhalt, Stadt",06369,191.54,13588,6752,6836,71
"Eggenfelden, St",84307,44.35,13532,6639,6893,305
"Erbach, Kreisstadt",64711,61.53,13513,6518,6995,220
"Grafing b.München, St",85567,29.57,13502,6573,6929,457
"Solms, Stadt",35606,34.05,13497,6700,6797,396
"Lorsch, Karolingerstadt",64653,25.24,13492,6524,6968,535
"Grünstadt, Stadt",67269,18.09,13468,6611,6857,744
"Zehdenick, Stadt",16792,223.06,13463,6731,6732,60
"Bad Soden-Salmünster, Stadt",63628,58.6,13463,6625,6838,230
"Eichstätt, GKSt",85072,47.78,13457,6573,6884,282
"Asperg, Stadt",71679,5.8,13437,6676,6761,2317
"Weißenhorn, St",89264,53.72,13428,6767,6661,250
"Haßfurt, St",97437,52.66,13385,6618,6767,254
"Erbach, Stadt",89155,63.29,13376,6742,6634,211
"Hilpoltstein, St",91161,89.71,13358,6802,6556,149
"Philippsburg, Stadt",76661,50.54,13345,6850,6495,264
"Tornesch, Stadt",25436,20.61,13319,6535,6784,646
"Höchstadt a.d.Aisch, St",91315,70.87,13319,6632,6687,188
"Beverungen, Stadt",37688,98.09,13313,6591,6722,136
"Bergen, Stadt",29303,164.4,13313,6586,6727,81
"Lich, Stadt",35423,77.63,13301,6537,6764,171
"Vöhringen, St",89269,23.69,13298,6535,6763,561
"Pegnitz, St",91257,99.98,13294,6489,6805,133
"Bad Salzdetfurth, Stadt",31162,67.2,13281,6492,6789,198
"Neckargemünd, Stadt",69151,26.16,13268,6469,6799,507
"Tauberbischofsheim, Stadt",97941,69.29,13256,6579,6677,191
"Löningen, Stadt",49624,143.53,13218,6606,6612,92
"Wolfhagen, Stadt",34466,111.95,13199,6679,6520,118
"Landau a.d.Isar, St",94405,84.39,13182,6523,6659,156
"Sendenhorst, Stadt",48324,96.95,13182,6537,6645,136
"Pfullendorf, Stadt",88630,90.5,13178,6567,6611,146
"Herbrechtingen, Stadt",89542,58.63,13174,6513,6661,225
"Burglengenfeld, St",93133,93.26,13129,6398,6731,141
"Bad Dürrheim, Stadt",78073,62.08,13121,6340,6781,211
"Wiesmoor, Stadt",26639,82.94,13116,6365,6751,158
"Rödental, St",96472,49.97,13115,6487,6628,262
"Waltershausen, Stadt",99880,60.62,13110,6506,6604,216
"Östringen, Stadt",76684,53.28,13104,6732,6372,246
"Quakenbrück, Stadt",49610,17.96,13090,6455,6635,729
"Weilburg, Stadt",35781,57.5,13086,6540,6546,228
"Herzberg am Harz, Stadt",37412,71.88,13051,6377,6674,182
"Velen, Stadt",46342,70.75,13044,6648,6396,184
"Montabaur, Stadt",56410,33.77,13042,6269,6773,386
"Möckern, Stadt",39291,523.94,13030,6609,6421,25
"Holzgerlingen, Stadt",71088,13.39,12984,6411,6573,970
"Dinklage, Stadt",49413,72.81,12963,6559,6404,178
"Plattling, St",94447,35.9,12960,6485,6475,361
"Krumbach (Schwaben), St",86381,44.64,12953,6388,6565,290
"Schleiden, Stadt",53937,121.67,12934,6387,6547,106
"Ettenheim, Stadt",77955,48.8,12932,6251,6681,265
"Wehr, Stadt",79664,35.66,12924,6254,6670,362
"St. Georgen im Schwarzwald, Stadt",78112,59.84,12882,6381,6501,215
"Steinheim, Stadt",32839,75.69,12877,6395,6482,170
"Neustadt a.d.Aisch, St",91413,61.21,12875,6221,6654,210
"Winterberg, Stadt",59955,147.95,12844,6423,6421,87
"Treuchtlingen, St",91757,103.38,12833,6472,6361,124
"Altötting, St",84503,23.07,12808,6059,6749,555
"Brunsbüttel, Stadt",25541,65.2,12801,6433,6368,196
"Linden, Stadt",35440,22.77,12764,6382,6382,560
"Spaichingen, Stadt",78549,18.5,12762,6317,6445,690
"Wasserburg a.Inn, St",83512,18.8,12759,6402,6357,679
"Sulingen, Stadt",27232,110.83,12755,6335,6420,115
"Borken (Hessen), Stadt",34582,82.3,12741,6417,6324,155
"Haselünne, Stadt",49740,159.43,12728,6351,6377,80
"Schüttorf, Stadt",48465,19.45,12676,6372,6304,652
"Buchloe, St",86807,36.18,12667,6239,6428,350
"Anklam, Stadt",17389,56.68,12635,6006,6629,223
"Fehmarn, Stadt",23769,185.49,12552,6152,6400,68
"Wernau (Neckar), Stadt",73249,10.89,12532,6302,6230,1150
"Olfen, Stadt",59399,52.43,12470,6091,6379,238
"Wächtersbach, Stadt",63607,50.79,12447,6171,6276,245
"Hadamar, Stadt",65589,40.99,12444,6253,6191,304
"Preußisch Oldendorf, Stadt",32361,68.75,12432,6106,6326,181
"Linnich, Stadt",52441,65.43,12420,6142,6278,190
"Pfarrkirchen, St",84347,52.35,12410,6025,6385,237
"Hungen, Stadt",35410,86.78,12407,6120,6287,143
"Hersbruck, St",91217,22.91,12388,6110,6278,541
"Bad Windsheim, St",91438,78.24,12379,6051,6328,158
"Bad Urach, Stadt",72574,55.42,12373,6118,6255,223
"Perleberg, Stadt",19348,138.69,12367,6142,6225,89
"Neustadt i. Sa., Stadt",01844,83.12,12341,5963,6378,148
"Bad Freienwalde (Oder), Stadt",16259,131.11,12316,5995,6321,94
"Jüterbog, Stadt",14913,176.48,12308,6017,6291,70
"Ludwigslust, Stadt",19288,78.63,12306,5905,6401,157
"Feuchtwangen, St",91555,137.21,12287,6162,6125,90
"Ebersbach-Neugersdorf, Stadt",02730,20.45,12265,5948,6317,600
"Rosbach v. d. Höhe, Stadt",61191,45.33,12262,6100,6162,271
"Twistringen, Stadt",27239,114.37,12257,6193,6064,107
"Schongau, St",86956,21.34,12252,6127,6125,574
"Neuenburg am Rhein, Stadt",79395,44.1,12234,6072,6162,277
"Gladenbach, Stadt",35075,72.28,12225,6065,6160,169
"Besigheim, Stadt",74354,16.83,12215,6068,6147,726
"Bad Wünnenberg, Stadt",33181,161.3,12200,6071,6129,76
"Eisenberg, Stadt",07607,24.67,12199,6203,5996,494
"Gaildorf, Stadt",74405,62.59,12180,6004,6176,195
"Sulz am Neckar, Stadt",72172,87.62,12173,6040,6133,139
"Wolgast, Stadt",17438,61.75,12172,5968,6204,197
"Weinsberg, Stadt",74189,22.22,12168,6119,6049,548
"Beelitz, Stadt",14547,181.29,12166,6106,6060,67
"Burladingen, Stadt",72393,123.31,12164,5967,6197,99
"Steinheim an der Murr, Stadt",71711,23.18,12162,6015,6147,525
"Titisee-Neustadt, Stadt",79822,89.64,12151,6001,6150,136
"Zwönitz, Stadt",08297,64.24,12126,5885,6241,189
"Bad Doberan, Stadt",18209,32.85,12124,5814,6310,369
"Hessisch Lichtenau, Stadt",37235,105.87,12120,6077,6043,114
"Pößneck, Stadt",07381,24.43,12117,5847,6270,496
"Ebersberg, St",85560,40.84,12116,5969,6147,297
"Blaubeuren, Stadt",89143,79.13,12104,6095,6009,153
"Coswig (Anhalt), Stadt",06869,295.75,12095,6127,5968,41
"Hemsbach, Stadt",69502,12.85,12085,5960,6125,940
"Monschau, Stadt",52156,94.6,12065,6068,5997,128
"Pritzwalk, Stadt",16928,167.47,12050,5953,6097,72
"Neuenrade, Stadt",58809,54.1,12012,5981,6031,222
"Röthenbach a.d.Pegnitz, St",90552,14.29,11977,5754,6223,838
"Gräfenhainichen, Stadt",06773,158.94,11919,5812,6107,75
"Bad Dürrenberg, Stadt",06231,36.15,11844,5835,6009,328
"Drolshagen, Stadt",57489,67.11,11837,5963,5874,176
"Velten, Stadt",16727,23.36,11815,5799,6016,506
"Bopfingen, Stadt",73441,76.94,11772,5825,5947,153
"Oestrich-Winkel, Stadt",65375,59.53,11738,5740,5998,197
"Geisenheim, Hochschulstadt",65366,40.35,11730,5741,5989,291
"Hagenow, Stadt",19230,67.54,11713,5768,5945,173
"Vilsbiburg, St",84137,68.84,11711,5872,5839,170
"Roding, St",93426,113.7,11706,5832,5874,103
"Erkner, Stadt",15537,16.53,11695,5551,6144,708
"Langelsheim, Stadt",38685,48.81,11684,5817,5867,239
"Osterhofen, St",94486,111.17,11676,5825,5851,105
"Hildburghausen, Stadt",98646,72.9,11661,5765,5896,160
"Hauzenberg, St",94051,82.79,11603,5783,5820,140
"Dinkelsbühl, GKSt",91550,75.16,11600,5709,5891,154
"Billerbeck, Stadt",48727,91.37,11594,5805,5789,127
"Wittingen, Stadt",29378,225.83,11589,5848,5741,51
"Lichtenstein/Sa., Stadt",09350,15.47,11584,5557,6027,749
"Walldürn, Stadt",74731,105.91,11565,5880,5685,109
"Ladenburg, Stadt",68526,19,11555,5645,5910,608
"Balve, Stadt",58802,74.81,11517,5715,5802,154
"Lindenberg i.Allgäu, St",88161,11.84,11500,5648,5852,971
"Lauenburg/ Elbe, Stadt",21481,9.55,11498,5757,5741,1204
"Wolmirstedt, Stadt",39326,54.29,11475,5585,5890,211
"Miesbach, St",83714,32.44,11414,5541,5873,352
"Bad Fallingbostel, Stadt",29683,63.7,11413,5640,5773,179
"Schöningen, Stadt",38364,35.47,11405,5618,5787,321
"Ochsenfurt, St",97199,63.57,11393,5678,5715,179
"Werther (Westf.), Stadt",33824,35.42,11365,5688,5677,321
"Laichingen, Stadt",89150,69.83,11347,5776,5571,162
"Stollberg/Erzgeb., Stadt",09366,38.99,11333,5465,5868,291
"Rheinau, Stadt",77866,73.5,11250,5653,5597,153
"Trostberg, St",83308,51.55,11234,5504,5730,218
"Schwaigern, Stadt",74193,49.49,11229,5707,5522,227
"Osterwieck, Stadt",38835,212.87,11221,5669,5552,53
"Lauffen am Neckar, Stadt",74348,22.63,11201,5498,5703,495
"Glückstadt, Stadt",25348,22.75,11190,5448,5742,492
"Schmölln, Stadt",04626,41.61,11171,5492,5679,268
"Bischofswerda, Stadt",01877,46.21,11169,5341,5828,242
"Mülheim-Kärlich, Stadt",56218,16.42,11157,5495,5662,679
"Oelsnitz/Erzgeb., Stadt",09376,26.28,11141,5400,5741,424
"Geisenfeld, St",85290,88.3,11130,5886,5244,126
"Marktheidenfeld, St",97828,35.7,11126,5380,5746,312
"Maxhütte-Haidhof, St",93142,34.69,11120,5588,5532,321
"Bad Belzig, Stadt",14806,236.06,11113,5474,5639,47
"Hammelburg, St",97762,128.88,11093,5488,5605,86
"Rothenburg ob der Tauber, GKSt",91541,41.67,11085,5389,5696,266
"Braunsbedra, Stadt",06242,74.3,11085,5644,5441,149
"Demmin, Hansestadt",17109,82.06,11052,5281,5771,135
"Welzheim, Stadt",73642,37.99,11043,5408,5635,291
"Diez, Stadt",65582,12.41,11011,5695,5316,887
"Rüthen, Stadt",59602,158.15,10955,5691,5264,69
"Braunfels, Stadt",35619,47.29,10954,5334,5620,232
"Gengenbach, Stadt",77723,61.9,10940,5255,5685,177
"Querfurt, Stadt",06268,155.42,10915,5319,5596,70
"Flöha, Stadt",09557,27.76,10894,5242,5652,392
"Donzdorf, Stadt",73072,39.82,10894,5469,5425,274
"Tangerhütte, Stadt",39517,294.83,10884,5413,5471,37
"Regen, St",94209,65.14,10884,5423,5461,167
"Lauingen (Donau), St",89415,44.39,10869,5367,5502,245
"Gronau (Leine), Stadt",31028,88.39,10849,5294,5555,123
"Bad Schwalbach, Kreisstadt",65307,40.27,10849,5410,5439,269
"Bad Nenndorf, Stadt",31542,23.22,10840,5130,5710,467
"Lorch, Stadt",73547,34.28,10796,5442,5354,315
"Meßstetten, Stadt",72469,76.8,10792,5602,5190,141
"Herbolzheim, Stadt",79336,35.48,10787,5415,5372,304
"Nossen, Stadt",01683,122.74,10771,5395,5376,88
"Burgstädt, Stadt",09217,25.87,10764,5249,5515,416
"Oberharz am Brocken, Stadt",38875,271.52,10731,5229,5502,40
"Rutesheim, Stadt",71277,16.22,10717,5305,5412,661
"Engen, Stadt",78234,70.56,10644,5256,5388,151
"Isselburg, Stadt",46419,42.8,10634,5360,5274,248
"Lichtenau, Stadt",33165,192.57,10632,5487,5145,55
"Bad Iburg, Stadt",49186,36.5,10630,5133,5497,291
"Felsberg, Stadt",34587,83.28,10611,5230,5381,127
"Zella-Mehlis, Stadt",98544,28.07,10595,5169,5426,378
"Bad Lauterberg im Harz, Stadt",37431,41.56,10548,5058,5490,254
"Haigerloch, Stadt",72401,76.44,10547,5263,5284,138
"Gommern, Stadt",39245,159.98,10543,5138,5405,66
"Steinbach (Taunus), Stadt",61449,4.4,10536,5090,5446,2392
"Boizenburg/ Elbe, Stadt",19258,47.43,10527,5218,5309,222
"Langenzenn, St",90579,46.33,10511,5079,5432,227
"Tangermünde, Stadt",39590,89.87,10471,5056,5415,117
"Riedlingen, Stadt",88499,64.95,10463,5232,5231,161
"Grevesmühlen, Stadt",23936,52.38,10440,5092,5348,199
"Oelsnitz/Vogtl., Stadt",08606,53.67,10435,5095,5340,194
"Altensteig, Stadt",72213,53.19,10406,5220,5186,196
"Pasewalk, Stadt",17309,55.21,10403,4917,5486,188
"Waldkirchen, St",94065,80.01,10384,5123,5261,130
"Steinau an der Straße, Brüder-Grimm-Stadt",36396,104.87,10335,5124,5211,99
"Bad Staffelstein, St",96231,99.51,10322,5081,5241,104
"Barmstedt, Stadt",25355,17.17,10283,5034,5249,599
"Münchberg, St",95213,68.78,10242,4915,5327,149
"Weilheim an der Teck, Stadt",73235,26.51,10237,5142,5095,386
"Meuselwitz, Stadt",04610,53.66,10230,4943,5287,191
"Büdelsdorf, Stadt",24782,6.48,10230,4942,5288,1579
"Lollar, Stadt",35457,21.41,10226,5080,5146,478
"Rehburg-Loccum, Stadt",31547,99.97,10219,5167,5052,102
"Friedrichsthal, Stadt",66299,8.99,10213,4996,5217,1136
"Gemünden a.Main, St",97737,75.06,10204,5068,5136,136
"Klötze, Stadt",38486,278.29,10201,5019,5182,37
"Gernsheim, Schöfferstadt",64579,40.11,10178,5030,5148,254
"Erlenbach a.Main, St",63906,16.31,10138,5034,5104,621
"Aulendorf, Stadt",88326,52.34,10137,5090,5047,194
"Aichtal, Stadt",72631,23.6,10129,5180,4949,429
"Süßen, Stadt",73079,12.79,10100,5074,5026,790
"Frohburg, Stadt",04654,108.51,10085,4983,5102,93
"Betzdorf, Stadt",57518,9.56,10082,4941,5141,1055
"Schotten, Stadt",63679,133.56,10063,5176,4887,75
"Wildau, Stadt",15745,9.1,10057,4923,5134,1105
"Blumberg, Stadt",78176,98.72,9996,5042,4954,101
"Wilkau-Haßlau, Stadt",08112,12.65,9973,4729,5244,788
"Osterburg (Altmark), Hansestadt",39606,229.76,9973,4850,5123,43
"Kenzingen, Stadt",79341,36.93,9949,4987,4962,269
"Niebüll, Stadt",25899,30.63,9946,4804,5142,325
"Wildberg, Stadt",72218,56.68,9937,4987,4950,175
"Neuenhaus, Stadt",49828,31.37,9925,4974,4951,316
"Bogen, St",94327,49.74,9920,4969,4951,199
"Wettin-Löbejün, Stadt",06193,127.11,9903,4895,5008,78
"Kemberg, Stadt",06901,235.21,9899,4909,4990,42
"Rüdesheim am Rhein, Stadt",65385,51.44,9892,4960,4932,192
"Grimmen, Stadt",18507,50.51,9888,4700,5188,196
"Nideggen, Stadt",52385,65.04,9886,4835,5051,152
"Nieder-Olm, Stadt",55268,11.22,9885,4789,5096,881
"Oldenburg in Holstein, Stadt",23758,39.68,9864,4795,5069,249
"Dassel, Stadt",37586,113.24,9860,4892,4968,87
"Bad Gandersheim, Stadt",37581,90.85,9858,4769,5089,109
"Bad Wildbad, Stadt",75323,105.22,9849,4837,5012,94
"Sebnitz, Stadt",01855,88.23,9817,4854,4963,111
"Mengen, Stadt",88512,49.82,9783,4901,4882,196
"Heubach, Stadt",73540,25.78,9765,4821,4944,379
"Bad Orb, Stadt",63619,47.78,9759,4650,5109,204
"Bockenem, Stadt",31167,109.96,9741,4869,4872,89
"Simbach a.Inn, St",84359,47.33,9736,4753,4983,206
"Schlitz, Stadt",36110,142.09,9716,4835,4881,68
"Neuenstadt am Kocher, Stadt",74196,41.17,9713,4882,4831,236
"Visselhövede, Stadt",27374,159.2,9700,4748,4952,61
"Hohenmölsen, Stadt",06679,75.31,9696,4689,5007,129
"Laubach, Stadt",35321,97.02,9695,4741,4954,100
"Brand-Erbisdorf, Stadt",09618,46.33,9640,4688,4952,208
"Bad König, Stadt",64732,46.73,9639,4670,4969,206
"Gudensberg, Stadt",34281,46.5,9632,4753,4879,207
"Lügde, Stadt der Osterräder",32676,88.64,9624,4780,4844,109
"Brandis, Stadt",04821,34.89,9619,4740,4879,276
"Burgau, St",89331,25.92,9617,4805,4812,371
"Luckau, Stadt",15926,207.43,9574,4746,4828,46
"Beilngries, St",92339,100.02,9560,4954,4606,96
"Niesky, Stadt",02906,53.81,9543,4681,4862,177
"Dissen am Teutoburger Wald, Stadt",49201,31.9,9539,4798,4741,299
"Zwiesel, St",94227,41.16,9500,4659,4841,231
"Niddatal, Stadt",61194,40.26,9495,4733,4762,236
"Ilsenburg (Harz), Stadt",38871,62.97,9491,4696,4795,151
"Zschopau, Stadt",09405,22.79,9490,4591,4899,416
"Sassnitz, Stadt",18546,47.14,9485,4546,4939,201
"Runkel, Stadt",65594,43.72,9477,4717,4760,217
"Trebbin, Stadt",14959,126.37,9474,4804,4670,75
"Bleckede, Stadt",21354,140.65,9467,4606,4861,67
"Bad Ems, Stadt",56130,15.41,9457,4555,4902,614
"Endingen am Kaiserstuhl, Stadt",79346,26.7,9445,4693,4752,354
"Fürstenau, Stadt",49584,78.65,9437,4623,4814,120
"Neustadt (Hessen), Stadt",35279,56.88,9427,4833,4594,166
"Wahlstedt, Stadt",23812,15.75,9397,4595,4802,597
"Höhr-Grenzhausen, Stadt",56203,15.88,9388,4593,4795,591
"Zörbig, Stadt",06780,113.68,9372,4648,4724,82
"Rehau, St",95111,80.33,9352,4569,4783,116
"Torgelow, Stadt",17358,72.19,9349,4598,4751,130
"Heilsbronn, St",91560,62.23,9347,4616,4731,150
"Bad Breisig, Stadt",53498,19.93,9341,4520,4821,469
"Raguhn-Jeßnitz, Stadt",06779,97.13,9307,4601,4706,96
"Obernkirchen, Stadt",31683,32.45,9302,4649,4653,287
"Eisenberg (Pfalz), Stadt",67304,18.75,9301,4627,4674,496
"Miltenberg, St",63897,60.25,9298,4560,4738,154
"Altlandsberg, Stadt",15345,106.6,9298,4636,4662,87
"Töging a.Inn, St",84513,13.65,9286,4534,4752,680
"Bad Liebenwerda, Stadt",04924,138.88,9283,4549,4734,67
"Zahna-Elster, Stadt",06895,148.58,9278,4648,4630,62
"Bad Liebenzell, Stadt",75378,33.78,9249,4537,4712,274
"Lüchow (Wendland), Stadt",29439,89.46,9214,4474,4740,103
"Kyritz, Stadt",16866,157.38,9192,4502,4690,58
"Bad Bevensen, Stadt",29549,48.36,9190,4230,4960,190
"Doberlug-Kirchhain, Stadt",03253,150.36,9179,4586,4593,61
"Wunsiedel, St",95632,54.88,9172,4455,4717,167
"Heiligenhafen, Stadt",23774,18.32,9162,4428,4734,500
"Herzberg (Elster), Stadt",04916,149,9129,4375,4754,61
"Osthofen, Stadt",67574,18.62,9128,4518,4610,490
"Elsfleth, Stadt",26931,115.19,9117,4661,4456,79
"Zwenkau, Stadt",04442,46.3,9082,4465,4617,196
"Ortenberg, Stadt",63683,54.69,9076,4473,4603,166
"Storkow (Mark), Stadt",15859,180.72,9070,4534,4536,50
"Wertingen, St",86637,51.88,9042,4493,4549,174
"Ballenstedt, Stadt",06493,86.65,9033,4412,4621,104
"Reinfeld (Holstein), Stadt",23858,17.36,9029,4470,4559,520
"Furtwangen im Schwarzwald, Stadt",78120,82.57,9025,4651,4374,109
"Kandel, Stadt",76870,26.69,9003,4448,4555,337
"Waldheim, Stadt",04736,41.71,9002,4582,4420,216
"Tecklenburg, Stadt",49545,70.49,8989,4506,4483,128
"Weißenthurm, Stadt",56575,3.99,8981,4636,4345,2249
"Bad Frankenhausen/Kyffhäuser, Stadt",06567,66.22,8975,4418,4557,136
"Furth im Wald, St",93437,67.06,8960,4491,4469,134
"Penig, Stadt",09322,63.37,8953,4385,4568,141
"Mittenwalde, Stadt",15749,99.12,8950,4580,4370,90
"Olbernhau, Stadt",09526,70.22,8944,4369,4575,127
"Mücheln (Geiseltal), Stadt",06249,98.58,8939,4443,4496,91
"Mansfeld, Stadt",06343,143.8,8929,4454,4475,62
"Breckerfeld, Hansestadt",58339,59.1,8920,4401,4519,151
"Hemau, St",93155,122.33,8907,4559,4348,73
"Freystadt, St",92342,80.56,8904,4582,4322,111
"Plön, Stadt",24306,36.73,8903,4280,4623,242
"Rain, St",86641,77.13,8902,4484,4418,115
"Calbe (Saale), Stadt",39240,56.67,8902,4292,4610,157
"Wetter (Hessen), Stadt",35083,104.56,8901,4503,4398,85
"Bad Griesbach i.Rottal, St",94086,70.13,8901,4385,4516,127
"Laufenburg (Baden), Stadt",79725,23.55,8884,4348,4536,377
"Auerbach i.d.OPf., St",91275,78.25,8859,4369,4490,113
"Elze, Stadt",31008,47.81,8853,4367,4486,185
"Bad Lauchstädt, Goethestadt",06246,85.37,8851,4372,4479,104
"Lauter-Bernsbach, Stadt",08315,30.28,8846,4308,4538,292
"Borgholzhausen, Stadt",33829,55.99,8835,4381,4454,158
"Ichenhausen, St",89335,34.27,8811,4478,4333,257
"Ochsenhausen, Stadt",88416,59.96,8808,4477,4331,147
"Mendig, Stadt",56743,23.75,8803,4384,4419,371
"Tirschenreuth, St",95643,103.95,8787,4242,4545,85
"Volkach, St",97332,60.19,8784,4358,4426,146
"Nittenau, St",93149,98.73,8725,4447,4278,88
"Colditz, Stadt",04680,84.09,8720,4281,4439,104
"Florstadt, Stadt",61197,39.6,8699,4303,4396,220
"Ueckermünde, Stadt",17373,85.87,8696,4248,4448,101
"Weida, Stadt",07570,36.8,8694,4280,4414,236
"Hemmoor, Stadt",21745,45.07,8690,4231,4459,193
"Kappeln, Stadt",24376,43.32,8676,4175,4501,200
"Klingenthal, Stadt",08248,50.44,8674,4209,4465,172
"Waldenbuch, Stadt",71111,22.7,8670,4254,4416,382
"Barth, Stadt",18356,41.18,8660,4139,4521,210
"Obernburg a.Main, St",63785,24.82,8647,4260,4387,348
"Schieder-Schwalenberg, Stadt",32816,60.04,8645,4296,4349,144
"Naunhof, Stadt",04683,39.72,8639,4223,4416,218
"Großräschen, Stadt",01983,81.86,8629,4239,4390,105
"Rauenberg, Stadt",69231,11.12,8627,4288,4339,776
"Barntrup, Stadt",32683,59.46,8616,4299,4317,145
"Kirchen (Sieg), Stadt",57548,39.76,8613,4241,4372,217
"Lützen, Stadt",06686,96.49,8612,4267,4345,89
"Hainichen, Stadt",09661,51.74,8609,4295,4314,166
"Neuötting, St",84524,36.6,8601,4191,4410,235
"Werneuchen, Stadt",16356,117.01,8584,4309,4275,73
"Lößnitz, Stadt",08294,30.49,8559,4172,4387,281
"Borgentreich, Orgelstadt4)",34434,138.94,/,/,/,/
"Bad Schussenried, Stadt",88427,55.01,8553,4334,4219,155
"Berching, St",92334,131.18,8541,4302,4239,65
"Barby, Stadt",39249,152.76,8535,4240,4295,56
"Teterow, Stadt",17166,47.07,8524,4169,4355,181
"Könnern, Stadt",06420,125.28,8519,4247,4272,68
"Schleiz, Stadt",07907,83.15,8509,4247,4262,102
"Lauta, Stadt",02991,42.13,8504,4156,4348,202
"Oranienbaum-Wörlitz, Stadt",06785,115.16,8493,4332,4161,74
"Bad Sooden-Allendorf, Stadt",37242,73.52,8476,4163,4313,115
"Vallendar, Stadt",56179,13.22,8443,4097,4346,638
"Wissen, Stadt",57537,34.88,8437,4193,4244,242
"Bersenbrück, Stadt",49593,42.54,8436,4176,4260,198
"Helmbrechts, St",95233,58.72,8425,4101,4324,143
"Premnitz, Stadt",14727,46.27,8423,4064,4359,182
"Großbottwar, Stadt",71723,25.51,8408,4218,4190,330
"Bad Schmiedeberg, Stadt",06905,160.02,8399,4158,4241,52
"Kirchberg, Stadt",08107,39.57,8395,4028,4367,212
"Leisnig, Stadt",04703,78.08,8392,4083,4309,107
"Nierstein, Stadt",55283,19.34,8388,4135,4253,434
"Hallstadt, St",96103,14.6,8356,4123,4233,572
"Kandern, Stadt",79400,62.26,8347,4102,4245,134
"Meßkirch, Stadt",88605,76.22,8347,4203,4144,110
"Bismark (Altmark), Stadt",39629,289.45,8335,4181,4154,29
"Dannenberg (Elbe), Stadt",29451,76.62,8330,4161,4169,109
"Staufenberg, Stadt",35460,28.6,8314,4091,4223,291
"Vetschau/Spreewald, Stadt",03226,111.51,8297,4178,4119,74
"Grafenau, St",94481,63.73,8276,4112,4164,130
"Landstuhl, Sickingenstadt, Stadt",66849,15.34,8276,4081,4195,539
"Willebadessen, Stadt",34439,128.41,8241,4175,4066,64
"Falkenstein/Vogtl., Stadt",08223,31.06,8235,3909,4326,265
"Kuppenheim, Stadt",76456,18.08,8228,3995,4233,455
"Vohburg a.d.Donau, St",85088,45.18,8216,4235,3981,182
"Kirn, Stadt",55606,16.53,8191,3975,4216,496
"Teuchern, Stadt",06682,81.36,8176,4087,4089,100
"Bad Bergzabern, Stadt",76887,10.71,8164,3865,4299,762
"Rheinsberg, Stadt",16831,328.22,8161,4094,4067,25
"Neustadt an der Orla, Stadt",07806,36.73,8158,3957,4201,222
"Lugau/Erzgeb., Stadt",09385,22.29,8147,3936,4211,365
"Neunburg vorm Wald, St",92431,110.14,8133,4178,3955,74
"Seeland, Stadt",06469,78.86,8130,4061,4069,103
"Viechtach, St",94234,62.47,8130,4042,4088,130
"Elsterwerda, Stadt",04910,40.58,8118,3962,4156,200
"Beeskow, Stadt",15848,77.81,8099,3892,4207,104
"Arnstein, St",97450,112.1,8090,4095,3995,72
"Staufen im Breisgau, Stadt",79219,23.32,8085,3850,4235,347
"Bad Lausick, Stadt",04651,70.02,8081,3966,4115,115
"Oederan, Stadt",09569,77.33,8079,4007,4072,104
"Altenberg, Stadt",01773,145.89,8060,4057,4003,55
"Zell am Harmersbach, Stadt",77736,36.41,8034,3978,4056,221
"Kellinghusen, Stadt",25548,18.81,8020,3960,4060,426
"Möckmühl, Stadt",74219,49.6,8011,4099,3912,162
"Neuenbürg, Stadt",75305,28.15,7999,3992,4007,284
"Dornstetten, Stadt",72280,24.2,7995,3957,4038,330
"Treuen, Stadt",08233,43.74,7993,3903,4090,183
"Bad Düben, Stadt",04849,45.83,7968,3836,4132,174
"Daun, Stadt",54550,49.02,7964,3894,4070,162
"Wörrstadt, Stadt",55286,16.75,7946,3927,4019,474
"Knittlingen, Stadt",75438,26.33,7928,3901,4027,301
"Rottenburg a.d.Laaber, St",84056,90.11,7924,3993,3931,88
"Simmern/ Hunsrück, Stadt",55469,11.96,7914,3799,4115,662
"Neresheim, Stadt",73450,118.51,7910,4074,3836,67
"Kühlungsborn, Stadt",18225,16.17,7909,3758,4151,489
"Medebach, Hansestadt",59964,126.05,7906,3973,3933,63
"Harzgerode, Stadt",06493,164.66,7906,3965,3941,48
"Herrieden, St",91567,81.66,7895,3933,3962,97
"Bützow, Stadt",18246,39.85,7887,4046,3841,198
"Bad Liebenstein, Stadt",36448,48.81,7884,3806,4078,162
"Pockau-Lengefeld, Stadt",09514,83.43,7848,3924,3924,94
"Schweich, Stadt",54338,31.1,7840,3718,4122,252
"Allstedt, Stadt",06542,149.81,7839,3931,3908,52
"Calau, Stadt",03205,163.5,7836,3908,3928,48
"Belgern-Schildau, Stadt",04874,158.98,7828,3927,3901,49
"Kirchheimbolanden, Stadt",67292,26.36,7790,3760,4030,296
"Oberkochen, Stadt",73447,23.55,7785,3829,3956,331
"Gundelfingen a.d.Donau, St",89423,54.06,7763,3869,3894,144
"Aken (Elbe), Stadt",06385,59.91,7754,3799,3955,129
"Bad Herrenalb, Stadt",76332,33.01,7745,3805,3940,235
"Bönnigheim, Stadt",74357,20.13,7725,3823,3902,384
"Hermsdorf, Stadt",07629,7.49,7724,3746,3978,1031
"Naila, St",95119,37.04,7715,3721,3994,208
"Löffingen, Stadt",79843,88.02,7698,3887,3811,87
"Markneukirchen, Stadt",08258,69.07,7696,3769,3927,111
"Hardegsen, Stadt",37181,84.03,7694,3765,3929,92
"Kalbe (Milde), Stadt",39624,272.7,7689,3905,3784,28
"Ramstein-Miesenbach, Stadt",66877,43.01,7677,3756,3921,178
"Sontra, Stadt",36205,111.29,7671,3857,3814,69
"Hüfingen, Stadt",78183,58.55,7635,3802,3833,130
"Münnerstadt, St",97702,93.11,7624,3894,3730,82
"Gerolstein, Stadt",54568,64.43,7613,3802,3811,118
"Ransbach-Baumbach, Stadt",56235,12.15,7578,3692,3886,624
"Roßwein, Stadt",04741,44.1,7571,3797,3774,172
"Baiersdorf, St",91083,11.81,7560,3738,3822,640
"Bad Berka, Stadt",99438,55.32,7540,3651,3889,136
"Eibenstock, Stadt",08309,112.22,7536,3727,3809,67
"Pulsnitz, Stadt",01896,26.75,7515,3676,3839,281
"Groitzsch, Stadt",04539,70.17,7496,3603,3893,107
"Bad Sachsa, Stadt",37441,33.2,7476,3622,3854,225
"Friedrichroda, Stadt",99894,36.88,7471,3619,3852,203
"Bad Kötzting, St",93444,62.15,7462,3662,3800,120
"Treuenbrietzen, Stadt",14929,212.43,7460,3679,3781,35
"Malchin, Stadt",17139,95,7456,3697,3759,78
"Gedern, Stadt",63688,75.24,7441,3780,3661,99
"Homberg (Ohm), Stadt",35315,88.02,7423,3746,3677,84
"Oppenheim, Stadt",55276,7.1,7417,3564,3853,1045
"Breuberg, Stadt",64747,30.76,7413,3657,3756,241
"Vohenstrauß, St",92648,74.91,7390,3613,3777,99
"Weikersheim, Stadt",97990,80.93,7387,3667,3720,91
"Radeburg, Stadt",01471,54.01,7383,3704,3679,137
"Esens, Stadt",26427,21.67,7343,3441,3902,339
"Teublitz, St",93158,38.23,7343,3653,3690,192
"Ebern, St",96106,95.01,7333,3728,3605,77
"Wriezen, Stadt",16269,95.15,7331,3638,3693,77
"Kremmen, Stadt",16766,209.55,7310,3647,3663,35
"Saarburg, Stadt",54439,20.63,7308,3512,3796,354
"Heringen (Werra), Stadt",36266,61.17,7306,3609,3697,119
"Freyung, St",94078,48.63,7305,3619,3686,150
"Gundelsheim, Stadt",74831,38.44,7305,3654,3651,190
"Meldorf, Stadt",25704,21.26,7299,3501,3798,343
"Otterndorf, Stadt",21762,33.55,7283,3467,3816,217
"Dettelbach, St",97337,60.94,7280,3666,3614,119
"Gröditz, Stadt",01609,28.94,7266,3586,3680,251
"Elzach, Stadt",79215,75.28,7259,3594,3665,96
"Gerbstedt, Stadt",06347,102.31,7257,3620,3637,71
"Hartha, Stadt",04746,54.4,7227,3543,3684,133
"Renchen, Stadt",77871,32.08,7189,3593,3596,224
"Lengenfeld, Stadt",08485,46.98,7187,3540,3647,153
"Scheßlitz, St",96110,94.87,7157,3682,3475,75
"Hecklingen, Stadt",39444,95.34,7146,3520,3626,75
"Schwarzenbach a.d.Saale, St",95126,59.18,7116,3502,3614,120
"Annweiler am Trifels, Stadt",76855,39.87,7113,3529,3584,178
"Laufen, St",83410,35.28,7109,3595,3514,202
"Neukirchen, Stadt",34626,66.26,7108,3584,3524,107
"Greding, St",91171,103.74,7088,3608,3480,68
"Haslach im Kinzigtal, Stadt",77716,18.67,7086,3494,3592,379
"Bernkastel-Kues, Stadt",54470,23.71,7057,3387,3670,298
"Zwingenberg, Stadt",64673,5.66,7031,3527,3504,1243
"Leipheim, St",89340,32.15,7007,3625,3382,218
"Jerichow, Stadt",39319,269.93,6999,3530,3469,26
"Bad Wimpfen, Stadt",74206,19.38,6985,3469,3516,360
"Moringen, Stadt",37186,82.39,6970,3577,3393,85
"Parsberg, St",92331,57.32,6955,3537,3418,121
"Römhild, Stadt",98630,122.45,6946,3503,3443,57
"Immenhausen, Stadt",34376,28.54,6936,3440,3496,243
"Birkenfeld, Stadt",55765,13.64,6923,3483,3440,508
"Gerolzhofen, St",97447,18.39,6908,3389,3519,376
"Geiselhöring, St",94333,99.69,6900,3498,3402,69
"Rodalben, Stadt",66976,15.69,6892,3392,3500,439
"Schelklingen, Stadt",89601,75.85,6880,3493,3387,91
"Kahla, Stadt",07768,7.89,6875,3351,3524,871
"Volkmarsen, Stadt",34471,67.47,6871,3450,3421,102
"Ebermannstadt, St",91320,49.95,6851,3392,3459,137
"Arendsee (Altmark), Stadt",39619,269.68,6850,3419,3431,25
"Neuhaus am Rennweg, Stadt",98724,80.98,6846,3424,3422,85
"Annaburg, Stadt",06925,224.28,6843,3398,3445,31
"Bonndorf im Schwarzwald, Stadt",79848,75.91,6834,3491,3343,90
"Neustadt-Glewe, Stadt",19306,94.14,6824,3474,3350,72
"Waldeck, Stadt",34513,115.73,6822,3397,3425,59
"Müncheberg, Stadt",15374,152.29,6820,3468,3352,45
"Waldmünchen, St",93449,101.17,6812,3359,3453,67
"Reichelsheim (Wetterau), Stadt",61203,27.6,6809,3395,3414,247
"Polch, Stadt",56751,28.68,6807,3421,3386,237
"Böhlen, Stadt",04564,24.56,6805,3352,3453,277
"Arnstein, Stadt",06333,121.69,6790,3382,3408,56
"Waldsassen, St",95652,66.53,6767,3362,3405,102
"Gau-Algesheim, Stadt",55435,13.99,6754,3266,3488,483
"Glashütte, Stadt",01768,95.64,6751,3412,3339,71
"Edenkoben, Stadt",67480,17.89,6742,3374,3368,377
"Dietenheim, Stadt",89165,18.75,6742,3349,3393,360
"Nortorf, Stadt",24589,12.77,6701,3242,3459,525
"Friedland, Stadt",17098,132.66,6679,3311,3368,50
"Bad Blankenburg, Stadt",07422,35.62,6666,3291,3375,187
"Höchstädt a.d.Donau, St",89420,37.45,6663,3320,3343,178
"Havelberg, Hansestadt",39539,149.12,6646,3296,3350,45
"Boxberg, Stadt",97944,101.71,6633,3386,3247,65
"Mitterteich, St",95666,39.38,6630,3260,3370,168
"Herdorf, Stadt",57562,17.99,6620,3247,3373,368
"Großröhrsdorf, Stadt",01900,26.54,6614,3221,3393,249
"Königsee-Rottenbach, Stadt",07426,84.37,6603,3306,3297,78
"Zierenberg, Stadt",34289,86.53,6600,3250,3350,76
"Malchow, Stadt",17213,44.71,6556,3166,3390,147
"Bernsdorf, Stadt",02994,59.78,6533,3211,3322,109
"Neuenstein, Stadt",74632,47.84,6498,3313,3185,136
"Rodewisch, Stadt",08228,26.88,6491,3191,3300,242
"Maulbronn, Stadt",75433,25.44,6490,3182,3308,255
"Osterburken, Stadt",74706,47.32,6485,3264,3221,137
"Ketzin/Havel, Stadt",14669,93.63,6474,3230,3244,69
"Falkenberg/Elster, Stadt",04895,82.16,6459,3203,3256,79
"Ilshofen, Stadt",74532,54.87,6459,3297,3162,118
"Burgkunstadt, St",96224,40.6,6455,3100,3355,159
"Großalmerode, Stadt",37247,37.62,6445,3154,3291,171
"Bad Sobernheim, Stadt",55566,54.18,6441,3155,3286,119
"Rosenfeld, Stadt",72348,51.11,6407,3223,3184,125
"Blankenhain, Stadt",99444,113.75,6406,3164,3242,56
"Beerfelden, Stadt",64743,71.19,6405,3213,3192,90
"Horstmar, Stadt der Burgmannshöfe",48612,44.76,6402,3238,3164,143
"Trochtelfingen, Stadt",72818,79.2,6377,3237,3140,81
"Rodenberg, Stadt",31552,15.62,6376,3167,3209,408
"Gammertingen, Stadt",72501,52.97,6367,3298,3069,120
"Wittenburg, Stadt",19243,80.08,6355,3259,3096,79
"Bad Brückenau, St",97769,23.71,6352,3113,3239,268
"Bad Rodach, St",96476,77.65,6352,3141,3211,82
"Nienburg (Saale), Stadt",06429,79.14,6341,3136,3205,80
"Grafenwöhr, St",92655,216.21,6336,3118,3218,29
"Uffenheim, St",97215,59.46,6332,3126,3206,106
"Schirgiswalde-Kirschau, Stadt",02681,24.34,6331,3175,3156,260
"Dohna, Stadt",01809,28.59,6325,3177,3148,221
"Alpirsbach, Stadt",72275,64.55,6291,3196,3095,97
"Thalheim/Erzgeb., Stadt",09380,10.79,6285,3038,3247,582
"Pegau, Stadt",04523,48.8,6284,3071,3213,129
"Güglingen, Stadt",74363,16.27,6269,3213,3056,385
"Altenkirchen (Westerwald), Stadt",57610,10.98,6256,2985,3271,570
"Spangenberg, Liebenbachstadt",34286,97.7,6241,3217,3024,64
"Neuffen, Stadt",72639,17.43,6234,3127,3107,358
"Zell im Wiesental, Stadt",79669,36.12,6226,3087,3139,172
"Nieheim, Stadt",33039,79.71,6222,3215,3007,78
"Beilstein, Stadt",71717,25.24,6212,3097,3115,246
"Geisingen, Stadt",78187,73.75,6211,3164,3047,84
"Neumarkt-Sankt Veit, St",84494,61.07,6204,3107,3097,102
"Lübz, Stadt",19386,57.73,6197,2986,3211,107
"Bleicherode, Stadt",99752,28.32,6157,3031,3126,217
"Heitersheim, Stadt",79423,11.71,6156,3030,3126,526
"Hermeskeil, Stadt",54411,30.89,6136,3044,3092,199
"Stavenhagen, Reuterstadt, Stadt",17153,41.02,6127,3078,3049,149
"Klingenberg a.Main, St",63911,21.12,6125,3065,3060,290
"Brotterode-Trusetal, Stadt",98596,49.68,6109,3009,3100,123
"Dietfurt a.d.Altmühl, St",92345,78.71,6094,3192,2902,77
"Plau am See, Stadt",19395,116.27,6076,2970,3106,52
"Windsbach, St",91575,68.12,6076,3140,2936,89
"Mügeln, Stadt",04769,55.08,6076,3001,3075,110
"Nabburg, St",92507,62.38,6067,3018,3049,97
"Thannhausen, St",86470,20.03,6067,2950,3117,303
"Braunlage, Stadt",38700,31.65,6049,3033,3016,191
"Kölleda, Stadt",99625,70.4,6042,2991,3051,86
"Herrnhut, Stadt",02747,74.12,6033,2978,3055,81
"Bad Lobenstein, Stadt",07356,48.92,6029,2991,3038,123
"Wassertrüdingen, St",91717,53.57,6023,3013,3010,112
"Rötha, Stadt",04571,46.16,6016,3066,2950,130
"Bad Königshofen i.Grabfeld, St",97631,69.51,6000,2914,3086,86
"Grünhain-Beierfeld, Stadt",08344,22.25,5999,2983,3016,270
"Glücksburg (Ostsee), Stadt",24960,39.7,5995,2859,3136,151
"Dornhan, Stadt",72175,44.92,5988,3011,2977,133
"Norderney, Stadt",26548,26.31,5981,2840,3141,227
"Linz am Rhein, Stadt",53545,17.98,5962,2855,3107,332
"Vilseck, St",92249,64.69,5937,2933,3004,92
"Oberlungwitz, Stadt",09353,14.68,5934,2891,3043,404
"Hachenburg, Stadt",57627,21.43,5932,2793,3139,277
"Geislingen, Stadt",72351,31.96,5919,2983,2936,185
"Gransee, Stadt",16775,121.68,5895,2962,2933,48
"Stadtroda, Stadt",07646,16.76,5893,2878,3015,352
"Riedenburg, St",93339,100.3,5891,2988,2903,59
"Vogtsburg im Kaiserstuhl, Stadt",79235,37.36,5882,2970,2912,157
"Bad Marienberg (Westerwald), Stadt",56470,9.95,5877,2897,2980,590
"Fürstenberg/Havel, Stadt",16798,213.85,5874,2908,2966,27
"Bad Hönningen, Stadt",53557,20.09,5837,2860,2977,290
"Rochlitz, Stadt",09306,23.76,5832,2782,3050,245
"Schlüsselfeld, St",96132,70.24,5823,2973,2850,83
"Tittmoning, St",84529,72.01,5818,2968,2850,81
"Hausach, Stadt",77756,36.07,5809,2908,2901,161
"Leun, Stadt",35638,28.66,5800,2905,2895,202
"Grebenstein, Stadt",34393,49.85,5799,2871,2928,116
"Marne, Stadt",25709,4.83,5796,2757,3039,1200
"Neustadt a.d.Waldnaab, St",92660,9.93,5795,2865,2930,583
"Meersburg, Stadt",88709,12.07,5788,2759,3029,479
"Hirschau, St",92242,74.96,5783,2842,2941,77
"Bräunlingen, Stadt",78199,62.14,5779,2888,2891,93
"Wemding, St",86650,31.6,5777,2821,2956,183
"Haiterbach, Stadt",72221,28.92,5774,2874,2900,200
"Wittichenau, Stadt",02997,61.02,5770,2811,2959,95
"Wolfach, Stadt",77709,67.97,5762,2883,2879,85
"Stadtoldendorf, Stadt",37627,24.92,5760,2830,2930,231
"Waibstadt, Stadt",74915,25.57,5719,2804,2915,224
"Westerburg, Stadt",56457,18.48,5717,2755,2962,309
"Schwarzheide, Stadt",01987,33.44,5711,2825,2886,171
"Dierdorf, Stadt",56269,31.98,5691,2827,2864,178
"Traben-Trarbach, Stadt",56841,31.35,5687,2821,2866,181
"Grabow, Stadt",19300,72.27,5684,2811,2873,79
"Großschirma, Stadt",09603,61.63,5678,2843,2835,92
"Biesenthal, Stadt",16359,60.92,5671,2807,2864,93
"Mellrichstadt, St",97638,55.99,5667,2824,2843,101
"Stolpen, Stadt",01833,60.89,5666,2833,2833,93
"Bad Gottleuba-Berggießhübel, Stadt",01816,88.72,5660,2823,2837,64
"Schrozberg, Stadt",74575,105.21,5654,2909,2745,54
"Eisfeld, Stadt",98673,52.68,5636,2841,2795,107
"Drebkau, Stadt",03116,143.91,5610,2844,2766,39
"Ruhla, Stadt",99842,38.55,5605,2758,2847,145
"Münzenberg, Stadt",35516,31.63,5604,2763,2841,177
"Zeil a.Main, St",97475,35.72,5594,2756,2838,157
"Ellrich, Stadt",99755,69.43,5583,2770,2813,80
"Leutershausen, St",91578,84.07,5578,2789,2789,66
"Schöppenstedt, Stadt",38170,39.73,5561,2742,2819,140
"Abenberg, St",91183,48.41,5554,2709,2845,115
"Gersfeld (Rhön), Stadt",36129,89.37,5550,2758,2792,62
"Bodenwerder, Münchhausenstadt",37619,29.05,5547,2692,2855,191
"Neubulach, Stadt",75387,24.69,5536,2753,2783,224
"Artern/Unstrut, Stadt",06556,24.19,5533,2703,2830,229
"Ohrdruf, Stadt",99885,39.78,5520,2778,2742,139
"Laage, Stadt",18299,81.6,5511,2741,2770,68
"Harburg (Schwaben), St",86655,73.16,5508,2768,2740,75
"Gadebusch, Stadt",19205,47.76,5507,2698,2809,115
"Ingelfingen, Stadt",74653,46.48,5479,2708,2771,118
"Hagenbach, Stadt",76767,15.86,5475,2706,2769,345
"Seelow, Stadt",15306,42.73,5451,2636,2815,128
"Dornburg-Camburg, Stadt",07774,30.77,5450,2665,2785,177
"Pfreimd, St",92536,51.45,5448,2741,2707,106
"Bredstedt, Stadt",25821,9.75,5432,2673,2759,557
"Falkenstein/Harz, Stadt",06463,102.97,5419,2751,2668,53
"Prüm, Stadt",54595,22.87,5414,2734,2680,237
"Kemnath, St",95478,56.8,5398,2631,2767,95
"Schleusingen, Stadt",98553,36.88,5391,2649,2742,146
"Burg Stargard, Stadt",17094,76.61,5387,2641,2746,70
"Tharandt, Stadt",01737,71.22,5383,2722,2661,76
"Lütjenburg, Stadt",24321,6.15,5377,2606,2771,874
"Kastellaun, Stadt",56288,8.47,5361,2698,2663,633
"Niedenstein, Stadt",34305,30.61,5354,2734,2620,175
"Otterberg, Stadt",67697,32.11,5340,2596,2744,166
"Battenberg (Eder), Stadt",35088,64.73,5337,2670,2667,82
"Geithain, Stadt",04643,30.22,5336,2591,2745,177
"Thum, Stadt",09419,18.9,5328,2634,2694,282
"Uebigau-Wahrenbrück, Stadt",04938,135.61,5324,2697,2627,39
"Wirges, Stadt",56422,10.11,5323,2590,2733,526
"Altentreptow, Stadt",17087,53.08,5310,2576,2734,100
"Cochem, Stadt",56812,21.18,5310,2696,2614,251
"Velburg, St",92355,175.66,5310,2673,2637,30
"Pottenstein, St",91278,73.29,5257,2644,2613,72
"Eltmann, St",97483,40.75,5256,2663,2593,129
"Kusel, Stadt",66869,14.37,5252,2565,2687,366
"Vacha, Stadt",36404,44.41,5237,2578,2659,118
"Rockenhausen, Stadt",67806,36.83,5233,2581,2652,142
"Arzberg, St",95659,43.19,5231,2613,2618,121
"Diemelstadt, Stadt",34474,82.58,5229,2663,2566,63
"Külsheim, Stadt",97900,81.43,5218,2680,2538,64
"Munderkingen, Stadt",89597,13.07,5205,2568,2637,398
"Borkum, Stadt",26757,30.98,5189,2447,2742,167
"Neudenau, Stadt",74861,32.91,5186,2619,2567,158
"Heimsheim, Stadt",71296,14.3,5175,2829,2346,362
"Stühlingen, Stadt",79780,93.16,5143,2595,2548,55
"Amöneburg, Stadt",35287,43.95,5136,2570,2566,117
"Zarrentin am Schaalsee, Stadt",19246,91.91,5134,2588,2546,56
"Unkel, Stadt",53572,8.16,5127,2446,2681,628
"Erbendorf, St",92681,67.56,5115,2535,2580,76
"Oettingen i.Bay., St",86732,34.22,5107,2535,2572,149
"Röbel/Müritz, Stadt",17207,30.69,5106,2416,2690,166
"Lindenfels, Stadt",64678,21.09,5105,2551,2554,242
"Naumburg, Stadt",34311,66.29,5104,2513,2591,77
"Hofheim i.UFr., St",97461,56.34,5090,2524,2566,90
"Treffurt, Stadt",99830,54.77,5080,2520,2560,93
"Hollfeld, St",96142,80.65,5078,2497,2581,63
"Freinsheim, Stadt",67251,13.59,5072,2454,2618,373
"Marienmünster, Stadt",37696,64.36,5071,2540,2531,79
"Pausa-Mühltroff, Stadt",07952,64.13,5052,2505,2547,79
"Reichenbach/O.L., Stadt",02894,62.64,5047,2499,2548,81
"Adorf/Vogtl., Stadt",08626,42.92,5038,2433,2605,117
"Trendelburg, Stadt",34388,69.35,5036,2506,2530,73
"Freren, Stadt",49832,48.97,5033,2557,2476,103
"Wilthen, Stadt",02681,17.04,5032,2415,2617,295
"Forchtenberg, Stadt",74670,38.09,5022,2557,2465,132
"Windischeschenbach, St",92670,36.37,5020,2512,2508,138
"Ronneburg, Stadt",07580,19.13,5015,2425,2590,262
"Monheim, St",86653,69.33,5006,2567,2439,72
"Lommatzsch, Stadt",01623,66.63,5000,2437,2563,75
"Dahme/Mark, Stadt",15936,162.59,4994,2482,2512,31
"Adelsheim, Stadt",74740,43.84,4990,2654,2336,114
"Roßleben, Stadt",06571,33.57,4984,2434,2550,148
"Tönning, Stadt",25832,44.41,4976,2472,2504,112
"Seehausen (Altmark), Hansestadt",39615,107,4968,2430,2538,46
"Steinbach-Hallenberg, Kurort, Stadt",98587,22.64,4965,2396,2569,219
"Kitzscher, Stadt",04567,29.04,4964,2432,2532,171
"Mahlberg, Stadt",77972,16.59,4964,2490,2474,299
"Schwaan, Stadt",18258,38.28,4959,2447,2512,130
"Spalt, St",91174,55.67,4947,2481,2466,89
"Oberviechtach, St",92526,62.42,4931,2451,2480,79
"Hitzacker (Elbe), Stadt",29456,58.67,4921,2356,2565,84
"Lichtenau, Stadt",77839,27.61,4917,2458,2459,178
"Todtnau, Stadt",79674,69.75,4912,2431,2481,70
"Creußen, St",95473,60.47,4902,2432,2470,81
"Strasburg (Uckermark), Stadt",17335,87.47,4890,2391,2499,56
"Crivitz, Stadt",19089,75.87,4880,2335,2545,64
"Niederstetten, Stadt",97996,104.05,4820,2447,2373,46
"Weismain, St",96260,90.14,4816,2435,2381,53
"Herbstein, Stadt",36358,79.98,4815,2468,2347,60
"Heringen/Helme, Stadt",99765,66.91,4812,2423,2389,72
"Eggesin, Stadt",17367,88.23,4800,2348,2452,54
"Emmelshausen, Stadt",56281,7.9,4783,2308,2475,605
"Lübtheen, Stadt",19249,120.17,4780,2539,2241,40
"Kröpelin, Stadt",18236,67.54,4773,2361,2412,71
"Triberg im Schwarzwald, Stadt",78098,33.33,4764,2380,2384,143
"Bad Sulza, Stadt",99518,45.49,4762,2312,2450,105
"Ehrenfriedersdorf, Stadt",09427,15.89,4762,2300,2462,300
"Geisa, Stadt",36419,71.94,4745,2383,2362,66
"Wörth a.d.Donau, St",93086,52.25,4743,2433,2310,91
"Freyburg (Unstrut), Stadt",06632,46.55,4738,2304,2434,102
"Oppenau, Stadt",77728,72.98,4729,2382,2347,65
"Stadtilm, Stadt",99326,17.34,4719,2317,2402,272
"Bischofsheim a.d.Rhön, St",97653,67.7,4707,2314,2393,70
"Wachenheim an der Weinstraße, Stadt",67157,24.97,4706,2313,2393,189
"Lauchheim, Stadt",73466,40.86,4700,2386,2314,115
"Creglingen, Stadt",97993,117.23,4697,2370,2327,40
"Rothenburg/O.L., Stadt",02929,72.4,4673,2326,2347,65
"Groß-Bieberau, Stadt",64401,18.27,4667,2327,2340,255
"Wörth a.Main, St",63939,15.88,4652,2290,2362,293
"Schömberg, Stadt",72355,23.25,4651,2374,2277,200
"Hartenstein, Stadt",08118,36.7,4651,2247,2404,127
"Heideck, St",91180,58.64,4632,2356,2276,79
"Niederstotzingen, Stadt",89168,29.81,4631,2311,2320,155
"Dahn, Stadt",66994,40.76,4616,2248,2368,113
"Scheinfeld, St",91443,45.12,4613,2273,2340,102
"Iphofen, St",97346,78.06,4595,2266,2329,59
"Nassau, Stadt",56377,17.55,4586,2282,2304,261
"Müllrose, Stadt",15299,69.24,4571,2209,2362,66
"Krautheim, Stadt",74238,52.9,4563,2377,2186,86
"Augustusburg, Stadt",09573,23.38,4556,2263,2293,195
"Marlow, Stadt",18337,140.52,4553,2354,2199,32
"Tengen, Stadt",78250,62.04,4524,2234,2290,73
"Schwarzenbach a.Wald, St",95131,36.7,4505,2196,2309,123
"Hallenberg, Stadt",59969,65.35,4474,2280,2194,68
"Tann (Rhön), Stadt",36142,60.45,4445,2234,2211,74
"Schönau, Stadt",69250,22.49,4444,2223,2221,198
"Dargun, Stadt",17159,118.01,4432,2182,2250,38
"Gefrees, St",95482,50.32,4426,2146,2280,88
"Wilster, Stadt",25554,2.71,4420,2173,2247,1631
"Königsbrück, Stadt",01936,78.48,4416,2184,2232,56
"Rabenau, Stadt",01734,30.73,4406,2208,2198,143
"Kirchberg an der Jagst, Stadt",74592,40.93,4403,2362,2041,108
"Peitz, Stadt",03185,13.49,4400,2185,2215,326
"Schönberg, Stadt",23923,38.21,4398,2156,2242,115
"Lunzenau, Stadt",09328,28.33,4384,2150,2234,155
"Rauschenberg, Stadt",35282,67.33,4382,2145,2237,65
"Selbitz, St",95152,27.74,4375,2068,2307,158
"Woldegk, Stadt",17348,156.29,4360,2211,2149,28
"Waldkappel, Stadt",37284,96.48,4359,2193,2166,45
"Heimbach, Stadt",52396,64.96,4352,2209,2143,67
"Rennerod, Stadt",56477,18.14,4339,2213,2126,239
"Putbus, Stadt",18581,66.68,4334,2132,2202,65
"Loitz, Stadt",17121,89.9,4334,2117,2217,48
"Dahlen, Stadt",04774,71.87,4332,2132,2200,60
"Vellberg, Stadt",74541,31.89,4332,2159,2173,136
"Dransfeld, Stadt",37127,28.91,4327,2112,2215,150
"Bad Berneck i.Fichtelgebirge, St",95460,33.56,4326,2142,2184,129
"Dingelstädt, Stadt",37351,20.45,4324,2181,2143,211
"Pressath, St",92690,66.34,4316,2110,2206,65
"Gerabronn, Stadt",74582,40.38,4301,2159,2142,107
"Liebenwalde, Stadt",16559,142.17,4277,2166,2111,30
"Waldershof, St",95679,60.37,4264,2128,2136,71
"Geringswalde, Stadt",09326,30.06,4263,2096,2167,142
"Berka/Werra, Stadt",99837,57.09,4253,2146,2107,74
"Sternberg, Stadt",19406,67.7,4252,2024,2228,63
"Hornberg, Stadt",78132,54.45,4245,2123,2122,78
"Tambach-Dietharz/Thür. Wald, Stadt",99897,41.63,4243,2126,2117,102
"Penzlin, Stadt",17217,115.56,4212,2104,2108,36
"Güsten, Stadt",39439,36.16,4187,2061,2126,116
"Schnaittenbach, St",92253,63.41,4184,2112,2072,66
"Lichtenfels, Stadt",35104,96.73,4180,2152,2028,43
"Wyk auf Föhr, Stadt",25938,8,4159,1903,2256,520
"Wanfried, Stadt",37281,46.9,4151,2062,2089,89
"Allendorf (Lumda), Stadt",35469,22.01,4141,2099,2042,188
"Nastätten, Stadt",56355,13.05,4129,2008,2121,316
"Baruth/Mark, Stadt",15837,233.84,4121,2104,2017,18
"Elsterberg, Stadt",07985,25.1,4119,2007,2112,164
"Johanngeorgenstadt, Stadt",08349,29.58,4115,2008,2107,139
"Zell (Mosel), Stadt",56856,44.95,4106,2072,2034,91
"Bad Buchau, Stadt",88422,23.75,4093,2035,2058,172
"Dassow, Stadt",23942,66.98,4076,2071,2005,61
"Niedernhall, Stadt",74676,17.71,4068,2070,1998,230
"Neckarbischofsheim, Stadt",74924,26.4,4066,2032,2034,154
"Waldenburg, Stadt",08396,25.06,4060,2001,2059,162
"Rheinböllen, Stadt",55494,16.36,4058,2005,2053,248
"Pappenheim, St",91788,64.32,4057,2027,2030,63
"Gemünden (Wohra), Stadt",35285,58.67,4056,2075,1981,69
"Baunach, St",96148,32.14,4051,2084,1967,126
"St. Blasien, Stadt",79837,54.41,4037,1967,2070,74
"Gräfenberg, St",91322,37.83,4013,2038,1975,106
"Baumholder, Stadt",55774,69.19,4004,1910,2094,58
"Brück, Stadt",14822,86.19,3999,2084,1915,46
"Netzschkau, Stadt",08491,12.51,3989,1928,2061,319
"Amorbach, St",63916,50.9,3987,1949,2038,78
"Eschenbach i.d.OPf., St",92676,35.13,3986,1915,2071,113
"Lorch, Stadt",65391,54.53,3986,2037,1949,73
"Mirow, Stadt",17252,158.3,3978,1924,2054,25
"Lambrecht (Pfalz), Stadt",67466,8.32,3960,1919,2041,476
"Seßlach, St",96145,72.53,3939,2004,1935,54
"Steinach, Stadt",96523,26.35,3899,1892,2007,148
"Kirchberg (Hunsrück), Stadt",55481,18.05,3895,1921,1974,216
"Wolkenstein, Stadt",09429,30.51,3894,1912,1982,128
"Regis-Breitingen, Stadt",04565,26.37,3883,1978,1905,147
"Neukloster, Stadt",23992,27.51,3881,1955,1926,141
"Hoya, Stadt",27318,8.42,3880,1907,1973,461
"Neubukow, Stadt",18233,25.12,3878,1923,1955,154
"Neckarsteinach, Stadt",69239,17.23,3872,1943,1929,225
"Tessin, Stadt",18195,24.51,3855,1874,1981,157
"Trebsen/Mulde, Stadt",04687,35.03,3851,1910,1941,110
"Bad Karlshafen, Stadt",34385,14.85,3823,1939,1884,257
"Vöhrenbach, Stadt",78147,70.47,3820,1944,1876,54
"Schiltach, Stadt",77761,34.21,3818,1875,1943,112
"Mühlberg/Elbe, Stadt",04931,89.2,3813,1908,1905,43
"Deidesheim, Stadt",67146,26.54,3797,1829,1968,143
"Lucka, Stadt",04613,12.93,3790,1822,1968,293
"Gehren, Stadt",98708,43.79,3782,1905,1877,86
"Freudenberg, Stadt",97896,34.76,3782,1901,1881,109
"Marktbreit, St",97340,20.16,3757,1946,1811,186
"Strehla, Stadt",01616,30.28,3748,1835,1913,124
"Seifhennersdorf, Stadt",02782,19.12,3747,1837,1910,196
"Bad Elster, Stadt",08645,19.77,3723,1784,1939,188
"Triptis, Stadt",07819,33.15,3721,1820,1901,112
"Ellingen, St",91792,31.25,3713,1865,1848,119
"Ruhland, Stadt",01945,37.22,3693,1803,1890,99
"Tegernsee, St",83684,22.77,3692,1732,1960,162
"Bad Schandau, Stadt",01814,46.76,3682,1812,1870,79
"Grünsfeld, Stadt",97947,44.72,3678,1860,1818,82
"Schlotheim, Stadt",99994,22.4,3660,1781,1879,163
"Wildenfels, Stadt",08134,20.69,3657,1833,1824,177
"Königsberg i.Bay., St",97486,61.88,3653,1830,1823,59
"Tanna, Stadt",07922,87.35,3640,1804,1836,42
"Greußen, Stadt",99718,19.21,3618,1786,1832,188
"Bad Muskau, Stadt",02953,15.38,3612,1748,1864,235
"Auma-Weidatal, Stadt",07955,55.91,3606,1801,1805,64
"Bad Köstritz, Stadt",07586,16.93,3593,1717,1876,212
"Goldberg, Stadt",19399,64.72,3591,1745,1846,55
"Gröningen, Stadt",39397,59.68,3583,1786,1797,60
"Mühlheim an der Donau, Stadt",78570,21.74,3582,1788,1794,165
"Geyer, Stadt",09468,18.56,3554,1727,1827,191
"Welzow, Stadt",03119,39.57,3552,1749,1803,90
"Langewiesen, Stadt",98704,27.51,3544,1772,1772,129
"Münstermaifeld, Stadt",56294,27.77,3543,1751,1792,128
"Krakow am See, Stadt",18292,87.37,3501,1752,1749,40
"Rehna, Stadt",19217,44.59,3492,1737,1755,78
"Goldkronach, St",95497,23.24,3492,1714,1778,150
"Saalburg-Ebersdorf, Stadt",07929,72.05,3484,1719,1765,48
"Eschershausen, Stadt",37632,23.92,3469,1747,1722,145
"Weißensee, Stadt",99631,46.71,3462,1701,1761,74
"Hirschhorn (Neckar), Stadt",69434,30.86,3462,1719,1743,112
"Joachimsthal, Stadt",16247,121.73,3446,1743,1703,28
"Gößnitz, Stadt",04639,14.07,3444,1671,1773,245
"Rötz, St",92444,66.68,3438,1759,1679,52
"Ludwigsstadt, St",96337,58.75,3427,1700,1727,58
"Kelbra (Kyffhäuser), Stadt",06537,40.55,3424,1703,1721,84
"Neustadt (Dosse), Stadt",16845,75.87,3406,1663,1743,45
"Owen, Stadt",73277,9.7,3406,1712,1694,351
"Neusalza-Spremberg, Stadt",02742,22.91,3405,1673,1732,149
"Speicher, Stadt",54662,15.36,3396,1684,1712,221
"Bernstadt a. d. Eigen, Stadt",02748,52,3390,1688,1702,65
"Wasungen, Stadt",98634,29.51,3382,1701,1681,115
"Lauscha, Stadt",98724,18.72,3380,1663,1717,181
"Kranichfeld, Stadt",99448,23.1,3374,1675,1699,146
"Kaltennordheim, Stadt",36452,40.47,3363,1703,1660,83
"Berga/Elster, Stadt",07980,43.52,3359,1664,1695,77
"Ostheim v.d.Rhön, St",97645,40.85,3352,1679,1673,82
"Hohnstein, Stadt",01848,64.64,3335,1671,1664,52
"Egeln, Stadt",39435,29.14,3331,1640,1691,114
"Ulmen, Stadt",56766,28.74,3330,1654,1676,116
"Kirchenlamitz, St",95158,48.48,3294,1618,1676,68
"Döbern, Stadt",03159,15.79,3291,1574,1717,208
"Wesselburen, Stadt",25764,5.14,3287,1583,1704,639
"Oberriexingen, Stadt",71739,8.16,3286,1661,1625,403
"Löwenstein, Stadt",74245,23.46,3283,1656,1627,140
"Stromberg, Stadt",55442,9.01,3283,1585,1698,364
"Sonnewalde, Stadt",03249,119.29,3261,1667,1594,27
"Nebra (Unstrut), Stadt",06642,25.42,3249,1593,1656,128
"Havelsee, Stadt",14798,81.97,3244,1635,1609,40
"Warin, Stadt",19417,44.45,3244,1585,1659,73
"Lychen, Stadt",17279,111.99,3222,1561,1661,29
"Wurzbach, Stadt",07343,72.32,3215,1604,1611,44
"Kirtorf, Stadt",36320,79.91,3213,1623,1590,40
"Burgbernheim, St",91593,42.3,3198,1581,1617,76
"Schöneck/Vogtl., Stadt",08261,55.06,3198,1551,1647,58
"Schönwald, St",95173,19.19,3195,1542,1653,166
"Bärnau, St",95671,74.41,3179,1648,1531,43
"Kaisersesch, Stadt",56759,8.18,3168,1543,1625,387
"Hillesheim, Stadt",54576,20.66,3158,1557,1601,153
"Weißenberg, Stadt",02627,50.96,3153,1626,1527,62
"Weißenstadt, St",95163,42.23,3151,1538,1613,75
"Lebus, Stadt",15326,54.29,3145,1583,1562,58
"Stadtsteinach, St",95346,39.79,3139,1530,1609,79
"Fridingen an der Donau, Stadt",78567,22.47,3137,1565,1572,140
"Liebenau, Stadt",34396,48.87,3126,1511,1615,64
"Klütz, Stadt",23948,44.41,3116,1497,1619,70
"Marktleuthen, St",95168,35.48,3111,1525,1586,88
"Bad Teinach-Zavelstein, Stadt",75385,25.17,3103,1606,1497,123
"Prichsenstadt, St",97357,48.87,3088,1587,1501,63
"Schönewalde, Stadt",04916,156.18,3085,1609,1476,20
"Bürgel, Stadt",07616,27.19,3079,1532,1547,113
"Waischenfeld, St",91344,57.19,3069,1583,1486,54
"Hatzfeld (Eder), Stadt",35116,58.51,3061,1566,1495,52
"Wolframs-Eschenbach, St",91639,25.47,3060,1525,1535,120
"Dömitz, Stadt",19303,60.57,3046,1492,1554,50
"Gützkow, Stadt",17506,57.65,3042,1528,1514,53
"Wesenberg, Stadt",17255,89.64,3040,1508,1532,34
"Eibelstadt, St",97246,7.07,3035,1455,1580,429
"Braubach, Stadt",56338,19.5,3034,1522,1512,156
"Waldenburg, Stadt",74638,31.55,3030,1552,1478,96
"Lindow (Mark), Stadt",16835,65.47,3028,1552,1476,46
"Ulrichstein, Stadt",35327,65.61,3002,1525,1477,46
"Jarmen, Stadt",17126,30.71,2981,1498,1483,97
"Friedland, Stadt",15848,174.23,2975,1512,1463,17
"Münchenbernsdorf, Stadt",07589,15.45,2967,1441,1526,192
"Schalkau, Stadt",96528,33.57,2939,1469,1470,88
"Merkendorf, St",91732,26.07,2938,1489,1449,113
"Frankenau, Stadt",35110,57.29,2930,1474,1456,51
"Adenau, Stadt",53518,18.56,2925,1430,1495,158
"Rhens, Stadt",56321,16.31,2917,1426,1491,179
"Gnoien, Stadt",17179,41.11,2911,1432,1479,71
"Laucha an der Unstrut, Stadt",06636,31.14,2909,1471,1438,93
"Remda-Teichel, Stadt",07407,79.76,2902,1483,1419,36
"Elterlein, Stadt",09481,45.74,2900,1449,1451,63
"Themar, Stadt",98660,20.18,2899,1415,1484,144
"Frauenstein, Stadt",09623,59,2884,1466,1418,49
"Meisenheim, Stadt",55590,10.33,2858,1399,1459,277
"Wustrow (Wendland), Stadt",29462,30.19,2856,1426,1430,95
"Oberwesel, Stadt",55430,18.08,2843,1374,1469,157
"Ravenstein, Stadt",74747,55.97,2821,1452,1369,50
"Elstra, Stadt",01920,32.63,2807,1410,1397,86
"Schillingsfürst, St",91583,27.5,2800,1389,1411,102
"Bad Bibra, Stadt",06647,49.77,2797,1407,1390,56
"Selters (Westerwald), Stadt",56242,8.7,2792,1385,1407,321
"Jöhstadt, Stadt",09477,49.7,2756,1413,1343,55
"Wallenfels, St",96346,45.65,2747,1374,1373,60
"Sankt Goar, Stadt",56329,23.17,2743,1375,1368,118
"Putlitz, Stadt",16949,119.68,2736,1418,1318,23
"Romrod, Stadt",36329,54.43,2729,1349,1380,50
"Sulzburg, Stadt",79295,22.74,2701,1309,1392,119
"Tribsees, Stadt",18465,54.98,2636,1287,1349,48
"Garding, Stadt",25836,3.06,2627,1252,1375,858
"Ebeleben, Stadt",99713,40.74,2623,1323,1300,64
"Großbreitenbach, Stadt",98701,19.6,2615,1344,1271,133
"Wegeleben, Stadt",38828,51.78,2595,1319,1276,50
"Schkölen, Stadt",07619,53.43,2590,1322,1268,48
"Kohren-Sahlis, Stadt",04655,36.8,2589,1303,1286,70
"Alsleben (Saale), Stadt",06425,23.64,2586,1237,1349,109
"Bad Wilsnack, Stadt",19336,79.62,2577,1235,1342,32
"Golßen, Stadt",15938,63.68,2575,1279,1296,40
"Lauterstein, Stadt",73111,23.31,2571,1261,1310,110
"Brüel, Stadt",19412,27.21,2566,1265,1301,94
"Friesack, Stadt",14662,84.01,2560,1299,1261,30
"Friedrichstadt, Stadt",25840,4.03,2523,1190,1333,626
"Schwanebeck, Stadt",39397,32.66,2516,1233,1283,77
"Gartz (Oder), Stadt",16307,61.89,2515,1227,1288,41
"Bad Tennstedt, Stadt",99955,27.42,2505,1231,1274,91
"Dommitzsch, Stadt",04880,30.44,2503,1237,1266,82
"Scheer, Stadt",72516,18.72,2496,1276,1220,133
"Gefell, Stadt",07926,45.22,2491,1226,1265,55
"Betzenstein, St",91282,51.84,2485,1246,1239,48
"Buttstädt, Stadt",99628,18.36,2481,1235,1246,135
"Osterfeld, Stadt",06721,27.61,2481,1280,1201,90
"Rastenberg, Stadt",99636,35.52,2478,1247,1231,70
"Schönau im Schwarzwald, Stadt",79677,14.72,2448,1223,1225,166
"Schönsee, St",92539,50.28,2446,1223,1223,49
"Ziesar, Stadt",14793,67.95,2444,1196,1248,36
"Pleystein, St",92714,42.4,2427,1207,1220,57
"Schlieben, Stadt",04936,78.65,2422,1199,1223,31
"Stadtlengsfeld, Stadt",36457,27.7,2415,1229,1186,87
"Großenehrich, Stadt",99718,63.34,2406,1214,1192,38
"Eckartsberga, Stadt",06648,35.97,2402,1225,1177,67
"Grebenau, Stadt",36323,55.37,2401,1229,1172,43
"Schlettau, Stadt",09487,21.22,2397,1155,1242,113
"Krempe, Stadt",25361,3.39,2377,1166,1211,701
"Ostritz, Stadt",02899,23.48,2365,1160,1205,101
"Creuzburg, Stadt",99831,35.4,2359,1164,1195,67
"Rethem (Aller), Stadt",27336,34.03,2324,1144,1180,68
"Fladungen, St",97650,46.34,2316,1179,1137,50
"Aach, Stadt",78267,10.68,2270,1168,1102,213
"Heldrungen, Stadt",06577,23.27,2266,1110,1156,97
"Katzenelnbogen, Stadt",56368,9.18,2235,1077,1158,244
"Garz/Rügen, Stadt",18574,65.89,2220,1118,1102,34
"Rosenthal, Stadt",35119,51.54,2215,1112,1103,43
"Hayingen, Stadt",72534,63.36,2209,1133,1076,35
"Hirschberg, Stadt",07927,24.13,2186,1084,1102,91
"Oderberg, Stadt",16248,36.12,2185,1108,1077,60
"Lenzen (Elbe), Stadt",19309,96.19,2160,1049,1111,22
"Mainbernheim, St",97350,12.21,2157,1086,1071,177
"Oberwiesenthal, Kurort, Stadt",09484,40.02,2156,1049,1107,54
"Leutenberg, Stadt",07338,57.52,2149,1060,1089,37
"Ortrand, Stadt",01990,7.36,2144,1029,1115,291
"Rerik, Stadt",18230,34.22,2136,1012,1124,62
"Gebesee, Stadt",99189,24.08,2135,1064,1071,89
"Königstein/Sächs. Schw., Stadt",01824,27.05,2128,1075,1053,79
"Veringenstadt, Stadt",72519,31.25,2127,1071,1056,68
"Meyenburg, Stadt",16945,50.74,2126,1068,1058,42
"Scheibenberg, Stadt",09481,9,2126,1062,1064,236
"Lauterecken, Stadt",67742,8.89,2097,1015,1082,236
"Wiesensteig, Stadt",73349,23.41,2066,1057,1009,88
"Bad Colberg-Heldburg, Stadt",98663,53.39,2059,1052,1007,39
"Magdala, Stadt",99441,20.58,2033,1009,1024,99
"Niemegk, Stadt",14823,45.12,2031,1044,987,45
"Gräfenthal, Stadt",98743,36.42,2007,989,1018,55
"Teuschnitz, St",96358,34.25,1987,966,1021,58
"Rieneck, St",97794,26.19,1984,962,1022,76
"Wolfstein, Stadt",67752,13.75,1978,999,979,144
"Marktsteft, St",97342,10.51,1978,1030,948,188
"Sachsenhagen, Stadt",31553,15.29,1929,958,971,126
"Schauenstein, St",95197,26.66,1925,949,976,72
"Bacharach, Stadt",55422,23.35,1901,950,951,81
"Wiehe, Stadt",06571,24.51,1900,943,957,78
"Plaue, Stadt",99338,18.19,1896,945,951,104
"Brüssow, Stadt",17326,101.83,1883,945,938,18
"Kindelbrück, Stadt",99638,13.36,1877,929,948,141
"Penkun, Stadt",17328,78.88,1874,953,921,24
"Teupitz, Stadt",15755,48.15,1868,967,901,39
"Sayda, Stadt",09619,35.3,1865,922,943,53
"Velden, St",91235,21.34,1829,916,913,86
"Widdern, Stadt",74259,25.23,1815,937,878,72
"Langenburg, Stadt",74595,31.4,1813,930,883,58
"Usedom, Stadt",17406,38.98,1810,889,921,46
"Hettingen, Stadt",72513,46.06,1802,907,895,39
"Neukalen, Stadt",17154,47.97,1758,874,884,37
"Bad Sülze, Stadt",18334,26.66,1755,872,883,66
"Ranis, Stadt",07389,10.57,1720,829,891,163
"Röttingen, St",97285,27.21,1713,836,877,63
"Oberweißbach/Thür. Wald, Stadt",98744,9.65,1693,789,904,175
"Lehesten, Stadt",07349,35.94,1665,841,824,46
"Ornbau, St",91737,15.16,1646,834,812,109
"Oberhof, Stadt",98559,23.4,1625,792,833,69
"Rhinow, Stadt",14728,31.66,1614,809,805,51
"Stadt Wehlen, Stadt",01829,10.85,1609,821,788,148
"Neuerburg, Stadt",54673,10.17,1563,781,782,154
"Arneburg, Stadt",39596,30.64,1526,744,782,50
"Lassan, Stadt",17440,28.18,1513,779,734,54
"Stadtprozelten, St",97909,10.87,1496,770,726,138
"Buckow (Märkische Schweiz), Stadt",15377,14.42,1490,734,756,103
"Hohenleuben, Stadt",07958,9.53,1474,801,673,155
"Aub, St",97239,17.54,1474,756,718,84
"Hornbach, Stadt",66500,13.33,1469,745,724,110
"Kroppenstedt, Stadt",39397,38.65,1447,729,718,37
"Hohenberg a.d.Eger, St",95691,15.66,1422,701,721,91
"Franzburg, Stadt",18461,15.2,1394,673,721,92
"Schwarzenborn, Stadt",34639,26.9,1373,809,564,51
"Manderscheid, Stadt",54531,10.06,1373,654,719,136
"Lieberose, Stadt",15868,73.03,1360,678,682,19
"Liebstadt, Stadt",01825,37.36,1352,698,654,36
"Sankt Goarshausen, Loreleystadt, Stadt",56346,7.06,1338,672,666,190
"Richtenberg, Stadt",18461,15.68,1325,665,660,85
"Buttelstedt, Stadt",99439,18.85,1324,665,659,70
"Neustadt am Kulm, St",95514,20.3,1126,543,583,55
"Orlamünde, Stadt",07768,7.47,1120,550,570,150
"Schraplau, Stadt",06279,7.06,1118,549,569,158
"Werben (Elbe), Hansestadt",39615,53.37,1100,566,534,21
"Obermoschel, Stadt",67823,10.15,1045,524,521,103
"Kupferberg, St",95362,8.29,1042,527,515,126
"Lichtenberg, St",95192,9.47,1036,504,532,109
"Clingen, Stadt",99718,10.75,1021,502,519,95
"Rothenfels, St",97851,12.07,1001,517,484,83
"Stößen, Stadt",06667,7.29,916,430,486,126
"Kyllburg, Stadt",54655,4.62,886,450,436,192
"Sandau (Elbe), Stadt",39524,18.58,862,417,445,46
"Kaub, Stadt",56349,13.05,854,443,411,65
"Märkisch Buchholz, Stadt",15748,24.86,786,391,395,32
"Ziegenrück, Stadt",07924,8.25,660,317,343,80
"Schnackenburg, Stadt",29493,23.76,548,278,270,23
"Neumark, Stadt",99439,8.67,480,247,233,55
"Ummerstadt, Stadt",98663,15.73,474,246,228,30
"Arnis, Stadt",24399,0.45,275,143,132,611
